気象等の特別警報の指標は、今後、変更されることはありますか？	指標は、今後も特別警報の実際の発表状況や効果等について検証しつつ、必要に応じて見直しを行っていきます。
大雨特別警報には、雨量の基準と低気圧の基準の２つが設定されていますが、どちらの基準で大雨特別警報が発表されるのですか？	数十年に一度の降雨量でなくても伊勢湾台風級の台風の場合は大雨特別警報を発表することがあり、また、伊勢湾台風級以外の台風や集中豪雨により数十年に一度の大雨が予想される場合に発表することもある、ということです。伊勢湾台風級の台風か、そうでない台風や集中豪雨により数十年に一度の降雨量となる大雨かのどちらか一方の基準のみを運用するということではありません。
市町村ごとの５０年に一度の値の一覧表が気象庁ホームページで公表されていますが、この値を予想したら特別警報が発表されるということですか？	特別警報は５０年に一度の大雨等が府県程度の広がりをもつ現象を対象に発表します。１つの市町村で５０年に一度の値になるだけでは特別警報にはなりません。５０年に一度の大雨の値がどの位の値なのかは特別警報の発表基準についてをご覧ください。
市町村ごとの５０年に一度の３時間降水量が「記録的短時間大雨情報」の発表基準雨量よりも小さいところがあるのはなぜですか？	市町村ごとの５０年に一度の値の一覧表に掲載しているのは、５km四方の地域ごとに求めた５０年に一度の雨量のうち、各市町村にかかるものについて平均した値です。これに対して「記録的短時間大雨情報」は、概ね県内全体でみて数年に一度発生するような雨量を基準としています。○○年に一度というものは、一般的に広い地域でみるほど大きな値となりますので、場所によってはご指摘のような関係になるところもあります。なお、特別警報の指標において、３時間降水量については５０年に一度の値及び１５０ミリを超える格子をカウントすることとしていますのでご留意ください。
大雪の特別警報は、積雪量だけではなく、表層雪崩の切迫等も視点に加えた基準及び運用とするべきではないですか？	大雪の特別警報は、積雪深に加え降雪量の予測も加味して発表します。具体的には５０年に一度の積雪深を超え、さらに大雪警報に相当する降雪が続くと予想した場合に発表します。なお、発表に係る指標は、今後も特別警報の実際の発表状況や効果等について検証しつつ、必要に応じ見直しを行っていきます。なだれについては、引き続き「なだれ注意報」により注意を呼び掛けていきます。
大雨特別警報が発表される主な事例は、数十年に一度どころか約２年に一度のペースで発生しているのではないですか？	数十年に一度とは地域ごとにみてのものであり、全国的にみた場合には、年に１～２回程度あるかもしくはないかの頻度になります。
大雨や大雪の大規模災害がほとんどない地域に対応するため、例えば「数十年に一度」に続いて「これまで経験したことの無い」などの表記を基準に加えてはいかがですか？	「数十年に一度」とは、その程度の頻度でしか発生しない現象という意味です。このため、これまでに経験したことのない現象の意も含むため、追記しないことにご理解願います。
沖縄などでは、本土と比べて台風が接近するときの勢力に大きな違いがありますが、本土と同じ基準で特別警報を発表するのですか？	台風を指標とする特別警報は、本州などでは伊勢湾台風級（中心気圧９３０hPa以下、風速５０メートル以上）を指標としますが、沖縄、奄美、小笠原では、中心気圧９１０hPa以下、風速６０メートル以上を指標として運用します。
温帯低気圧は暴風警戒域や強風域の発表がなく、被害範囲が不確定なので、台風とは別の表現に変えるべきではないですか？	温帯低気圧は台風のように暴風警戒域を示してはいないものの、猛烈に発達する温帯低気圧のような現象についても暴風の対象となる地域を予想することが可能です。このため、台風・温帯低気圧によらず、伊勢湾台風級に発達した低気圧により猛烈な風が吹くような地域に対し特別警報を発表することを考えており、現在の基準の表現が適切と考えています。
基準の中に具体的な過去の災害実例をもとにして想定される被害や住民が取るべき行動を加える等してはいかがですか？	基準に該当する過去の災害事例や住民がとるべき行動の例を気象庁ホームページで公開していますが、今後も特別警報発表時の状況をイメージしやすい資料を引き続き作成し公表していきます。基準としては、現在の表現とさせていただきたく、ご理解願います。
特別警報と土砂災害警戒情報の位置づけはどうなっていますか？	土砂災害警戒情報の運用や土砂災害警戒情報が避難勧告の判断を支援するとの位置づけは、特別警報の実施後においても当面は変わりません。特別警報が発表された場合には、府県予報区内で警報基準をはるかに超える現象が発現しつつある状況であることをご認識いただいた上で、より切迫感をもって防災対応に臨んでいただき、避難勧告等の判断を行う際は、土砂災害警戒情報の発表状況や補足情報となる土砂災害警戒メッシュ情報の推移を把握しながら、総合的に判断していただくものと考えています。　なお、土砂災害に関する警報等の改善については、平成24年度に開催された「土砂災害への警戒の呼びかけに関する検討会」提言および現在開催中の「防災気象情報の改善に関する検討会」から出される予定の提言を踏まえ、別途検討を進めていくこととしております。
特別警報と既存の記録的短時間大雨情報の違いは何ですか。廃止されたりはしないのですか？	特別警報は予想により発表するもので、記録的短時間大雨情報は、観測された雨量をお知らせするものです。現時点で廃止する予定はありません。
洪水の特別警報がないのはなぜですか？	洪水の流況は、治水施設の整備状況やその操作により大きく変わるものであり、また、洪水の予報については雨量等の気象現象に加え、治水施設の整備状況やその操作、河川の形状等も踏まえ総合的に把握して行うことが必要です。このため、洪水により重大な災害が発生するおそれが著しく大きい場合においても、気象庁と国土交通省または都道府県とが共同で、指定河川においては洪水予報を、水位情報周知河川においては水位情報の一般周知を各々適切に実施することとしています。こうしたことから、洪水については特別警報を行わないこととしておりますので、指定河川洪水予報や水位情報周知河川の水位の状況に応じた防災対応をとってください。
防災気象情報の種類が多いので、体系的に整理するべきではないですか？	防災気象情報の発表の流れを土砂災害、水害、高潮災害別にまとめていますのでご覧ください。また、現在中期的な観点から防災気象情報の整理について検討しているところです。今後、特別警報も含めて、より分かりやすく効果的な体系整理を行っていきます。
注意報から特別警報になる可能性はあるのですか？	注意報から特別警報になる場合もあります。
特別警報の発表単位は、警報・注意報と同様に市町村単位となるのですか。また、浸水害、土砂災害の種別はあるのですか？	特別警報の発表地域単位は、現行の警報等と同様に市町村単位で発表します。大雨特別警報には、浸水害・土砂災害の種別があります。
発表区域が市町村単位とのことですが、その場合、県内の全市町村が伊勢湾台風級で統一できるのですか。県内一律に特別警報の基準とする根拠は何ですか？	例えば、大雨特別警報について現在提示している基準は、「台風や集中豪雨により数十年に一度の降雨量となる大雨が予想され、若しくは、数十年に一度の強度の台風や同程度の温帯低気圧により大雨になると予想される場合」です。これは、数十年に一度の降雨量が予想されなくても伊勢湾台風クラスの台風の場合は大雨特別警報を発表することがあり、また、伊勢湾クラス以外の台風や集中豪雨により府県程度の範囲で数十年に一度の大雨が予想される場合に発表することもある、ということです。伊勢湾台風クラスの台風か、そうでない台風や集中豪雨により数十年に一度の降雨量となる大雨かのどちらか一方の基準のみを運用するということではありません。
雨が降っていないのに、大雨警報が発表されているのはなぜですか？	大雨警報は、土砂災害や浸水害など、重大な災害をもたらす大雨が予想される場合に発表しています。　自分の頭の上で雨が降っていないのに、大雨警報が発表されているケースとしては、以下の３つが考えられます。（１）　これから降る大雨を予想して発表している場合　大雨警報は、重大な災害をもたらす大雨を予想した場合に発表しますので、大雨警報が発表された直後には、まだ雨が降っていないこともあります。大雨警報とあわせて、高解像度降水ナウキャストなどで、雨の状況をご確認ください。（２）　これまでに降った雨で土砂災害のおそれがある場合　大雨によって発生する土砂災害は、土壌中の水分量が多いほど発生の可能性が高く、何時間も前に降った雨が影響して土砂災害が発生する場合もあります。 このため、すでに雨が止んでいる場合でも、それまでに降った雨が土壌中に浸透・貯留しているために土砂災害のおそれがある場合には、大雨警報の発表を継続します。大雨警報とあわせて、土砂災害警戒情報や土砂災害警戒判定メッシュ情報などで土砂災害発生の危険度をご確認ください。（３）　雨の降り方が局地的な場合　大雨を含めた気象警報は、対象地域のわかりやすさや防災上の観点から、市町村単位で発表しています。このため、雨の降り方が局地的な場合、自分の頭の上では雨が降っていなくても、市町村内の他の場所では、重大な災害をもたらすような大雨となっている場合があります。大雨警報とあわせて、高解像度降水ナウキャストなどで、雨の状況をご確認ください。
暴風や高潮などが発生する前から警報・注意報が発表されている場合があるのはなぜですか？	警報・注意報は、防災機関や住民に伝わって避難行動などがとられるまでに要する時間を考慮して、現象が「予想」された場合に発表しています。特に台風の進路予想により暴風や高潮などが予想される場合は、早めに対策が実施できるよう、現象が発生する前から十分な猶予時間をとって警報・注意報を発表しています。ただし、現象の予想が難しい場合には、結果として猶予時間が確保できない場合もあります。　警報・注意報の本文では、暴風などの災害につながる現象が予想される時間帯について「１０日夜おそくから１１日朝にかけて」等の表現を行っています。
傘をさせない、自転車に乗ることが危険なくらい風が強いのに暴風警報を発表しない（または解除する）のはなぜですか？	警報・注意報の発表基準は過去の災害発生との関係で市町村等防災機関と調整してきめています。また、警報・注意報は市町村等の防災活動に利用いただくとともに、避難行動に役立てていただいています。そして、警報・注意報は、防災機関や住民に伝わって防災活動や避難行動がとられるまでに要する時間を考慮して、基準に到達すると予想した場合に発表しており、基準を下回ったと判断したときに解除（または注意報に切り替え）しています。　暴風警報の場合も、基準をを上回ると予想したときに発表し、下回って再び上回らないと判断したときに解除（または強風注意報に切り替え）しています。風の吹き方は絶えず強弱があり、最大瞬間風速は最大風速の１．５倍程度になることが多いですが、大気の状態が不安定な場合等では３倍以上になることがあります。また、地形や建物に影響されて局地的に強い風が吹くことがあります。（参考）風の強さと吹き方
警報・注意報の基準は、どのようにして決めるのですか？	災害は、気象現象の強さとそれぞれの地域の社会的環境や季節などの違いにより千差万別です。気象台では、警報・注意報の対象となる地域ごとに過去に災害が起こったときの気象状況と災害との関係を調査して都道府県の防災機関とも協議し、災害の恐れがあるときの現象の強さの目安を作成しています。この目安を「注意報基準」、「警報基準」と呼んでいます。　さらに、環境の変化、災害の様相の変化などに対応して常に点検を行い、適切な値に保っています。気象条件がこれらの基準に達すると予想されるときは、警報・注意報を発表します。基準は、防災機関へ知らせるほか、警報・注意報発表基準一覧表にも掲載しています。また、各地の気象台や測候所での閲覧も可能です。
警報の更新時刻は決まっていますか？	天気予報とは異なり、警報や注意報は発表時刻や更新時刻が決まっているものではなく、発表時刻以降解除されるまでは有効です。警報は、雨や風などの気象現象によって重大な災害が起こるおそれがあるときに随時発表し、次に何らかの変更（当該警報の解除、警報の内容変更、他の警報や注意報の追加発表や解除等）が発表されるまでは、その警報が有効になります。例えば、気象庁ホームページを６時にご覧になって、お住まいの市町村に５時３０分あるいは前日の２１時３０分等の発表時刻で暴風警報が表示されていれば、ご覧になった６時の時点でも警報が発表されている、有効である、ということになります。なお、気象庁ホームページは警報や注意報が発表されると数分以内に更新されますので、例えば５時５５分に警報の発表があったとすると、６時の時点でまだ気象庁ホームページに反映されていない可能性がありますのでご注意ください。
隣の市は警報がよく出るのに、○○市は警報があまり出ないのはなぜですか？	警報・注意報の発表基準は、災害の発生と気象要素との関係を地域ごとに調べ、市町村等防災機関と調整して決めています。このため、警報・注意報の発表基準値は市町村によって多少異なります。○○市の警報発表基準値が周りの市町村より高い場合、周りの市町村に警報が発表されても、○○市に警報が発表されないことがあります。
土砂災害警戒情報は、どのような時に発表するものですか？	土砂災害警戒情報は、大雨警報（土砂災害）が発表されている状況で、大雨による土砂災害発生の危険度がさらに高まった時に、市町村長が避難勧告等を発令する際の判断や住民の自主避難の参考となるよう、都道府県と気象庁が共同で発表する防災情報です。　利用上の留意点など、詳しくは、土砂災害警戒情報を参照してください。
土砂災害警戒判定メッシュ情報は、どのように利用するものですか？	土砂災害警戒判定メッシュ情報は、土砂災害警戒情報を補足する情報です。５km四方の領域（メッシュ）ごとに、土砂災害発生の危険度を５段階に判定した結果を表示しています。避難にかかる時間を考慮して、危険度の判定には２時間先までの土壌雨量指数等の予想を用いています　土砂災害警戒情報や大雨警報（土砂災害）が発表されたときには、土砂災害警戒判定メッシュ情報で、土砂災害発生の危険度が高まっている詳細な領域を把握することができます。特に、土砂災害警戒情報の基準に到達した紫色のメッシュ内の土砂災害危険箇所・土砂災害警戒区域等では、人命や身体に危害を及ぼす土砂災害がいつ発生してもおかしくない非常に危険な状況となっています。土砂災害の危険度が高まっている領域にお住まいの方は、土砂災害危険箇所・土砂災害警戒区域等の外の少しでも安全な場所への早めの避難を心がけてください。　なお、内閣府の「避難勧告等の判断・伝達マニュアル作成ガイドライン」では、市町村が避難勧告等を発令する際のメッシュ情報の活用方法として「実況または予想で大雨警報の土壌雨量指数基準に到達した場合には避難準備情報を発令し、予想で土砂災害警戒情報の基準に到達した場合には避難勧告を発令し、実況で土砂災害警戒情報の基準に到達した場合には避難指示を発令する。」と記載されています。
河川を指定した洪水予報とは、何ですか？	河川の増水やはん濫などに対する水防活動の判断や住民の自主避難の参考となるよう、気象庁は、各河川を管理する国土交通省または都道府県の機関と共同して、あらかじめ指定した河川について、区間を決めて水位または流量を示した洪水の予報を行っています。詳しくは、指定河川洪水予報を参照してください。
記録的短時間大雨情報は、どのような情報で、どんなときに発表されるのですか？	大雨警報が発表されているとき、台風や前線の活動により数年に１度という大雨を観測または解析することがあります。このような場合に一層の警戒を呼びかけるものとして、数年に１度の大雨となっている地域とその雨量を簡潔に記述した記録的短時間大雨情報を発表します。詳しくは、記録的短時間大雨情報を参照してください。
天気は気象衛星で予想しているのですか？	気象衛星の観測により、雲の動き等多くの情報を得ることはできますが、それだけでは天気の予想はできません。天気を予想するためには、将来の大気の状態がどうなるかを予想する必要があります。気象庁では、国内だけでなく、世界各国で行われる地上や上空の観測データを活用した数値予報を用いて将来の大気の状態を予想しています。スーパーコンピュータを用いて、地球全体の大気の状態のこれからの変化をシミュレーション技術で計算し、明日、明後日、・・・一週間後の大気の状態を求めることができるということです。
曇り時々雨、曇り一時雨、曇りのち雨は、どう違うのですか？	雨の降り方（断続的や連続的）や予報期間中における降っている時間の割合、降り方の傾向によって、予報表現が決まっています。
天気についてのことわざはあてになるのですか？	「夕焼けの翌日は晴れ」とか、「猫が顔を洗うと雨」など天気に関することわざはたくさんありますが、全て迷信ということはなく、中には科学的に説明の付くものがあります。　例えば、「太陽や月がカサをかぶると雨になる」というのは、低気圧が近づくと上空には巻層雲が現れ、この雲粒が太陽や月の光を回折（かいせつ）させるためカサ（暈）ができるのです。低気圧が近づいても１００％雨が降るというわけではありませんが、単なる迷信というわけでもありません。
天気予報はどのくらい当たっているのですか？	天気予報の成績を付けるのは実は非常に難しいのです。「晴れ時々曇り」という予報を出して、結果が「曇り時々晴れ」という天気になった場合、０点ですか？５０点でしょうか？そこで、気象庁では１ミリ以上の雨が降る、降らないの予報に関して採点しています。その結果は、2014年の１７時発表の明日の予報については全国平均で８４点でした。2014年の週間天気予報については全国平均で３日先が７７点、７日先が８４点でした。（参考）予報精度の検証結果
降水確率はどうやって決めるのですか？	気象庁が発表する降水確率は、指定された時間帯の間に１ミリ以上の降水がある確率です。「東京地方の１２時から１８時までの降水確率は７０％」という予報の場合、東京地方のある地点においては、１２時から１８時までの間に１ミリ以上の降水がある確率が７０％ということになります。降水確率７０％という予報が１００回発表された場合、その内７０回で１ミリ以上の降水があると言い換えることもできます。
「降水確率」の意味について教えてください。	「東京地方の正午から午後６時までの降水確率は７０パーセント」を例にします。　気象庁の降水確率は指定された時間帯（ここでは正午から午後６時）の間に１ミリ以上の降水の降る確率と定義されています。降水確率は降水の有無のみについて確率を示すもので、降水が連続的か断続的か、一時的とすればその時間帯のどこかなどの雨の降り方や１ミリ以上のである限り降水量の多少については何も示していません。予報が出される地域内のどの点でも同じ確率として定義されます。よって、例の意味は「東京地方のどの地点でも正午から午後６時までの降水量の合計が１ミリ以上となる確率が７０パーセントである」ということになります。なお、降水確率が７０パーセントというのは「７０パーセントの予報が１００回出されたとき、およそ７０回は１ミリ以上の降水がある」ということを意味しています。
予想最高気温や最低気温はどうやって予想するのですか。	このページの一番上の回答にあるように、将来の大気の状態は数値シミュレーション技術を使って求めることができます。この将来の大気の状態の要素には地上付近や上空の気温もあります。数値シミュレーションで求められたこれらの気温などから、予想最高気温や最低気温を求めることができます。
テレビ局によって天気予報の内容が違うことがあるのはなぜですか？	天気予報については、気象庁長官の許可を得れば気象庁以外の方でも一般利用者向けの独自予報を発表することができます。この許可を受けた方を「予報業務許可事業者」といい、許可の範囲内で独自の判断で予報を発表できます。このため、同じ場所の天気予報でも、予報業務許可事業者によって異なった内容になる場合もありえます。テレビ局自身が予報業務許可を得ているところもありますが、多くのテレビ局では、気象庁や予報業務許可事業者から予報を入手していますので、入手先によって放送される予報が異なることもあります。　なお、予報業務許可事業者には、国家資格である気象予報士を置き、予報は気象予報士に行わせることや、予報の基礎となる気象データや警報・注意報を入手することが義務付けられています。このようにすることで、許可事業者が発表する予報は、一定以上の質が確保されるようにしています。
予報用語を知りたいのですが？	気象庁が天気予報等で用いる予報用語については、予報用語をご利用ください。
天気予報で雨（傘）マークがなかったのに雨が降っているのですが？	こんにちは！天気相談所です！　第３回「傘マーク出ていないのに雨降ってる！」をご覧ください。
天気予報で晴れだったのに雲が出ていますが？	こんにちは！天気相談所です！　第２回「お日様マークだけなのに雲が出てるんですけど」をご覧ください。
天気予報で｜と／が出ていますが、違いは何ですか？	「｜」は「時々　または　一時」、「／」は「のち」を意味します。例えば、「曇り時々雨」と「曇り一時雨」は同じマークとなります。気象庁ホームページの全国の天気予報の図の右上に、記号の凡例を示しています。これらの記号は、天気変化の概要だけを示すものですので、天気予報を利用される際には、より詳細な天気予報文をご覧ください。詳しくは、天気予報等で用いる用語（時に関する用語）をご覧ください。
天気予報の／は、午前の天気／午後の天気という意味ですか？	「／」は「のち」を示しており、予報期間内の前と後で天気が異なるときに用います。ある日の天気予報が「晴れのち曇り」の場合は、その日の天気が晴れから曇りに変わることを表現していますが、午前と午後で変わるだけではありません。今日、明日の予報では「晴れ夕方から曇り」など時間帯を示した表記としていますので、天気予報文もご覧ください。
天気予報で夜遅くから雨の場合でも雨（傘）マークをつけるのはなぜですか？	気象庁ホームページの天気予報マークは、対象となる日の天気を１つまたは２つのマークで概要がわかるように表示しています。この際、雨や雪が降る場合は優先して表示しています（情報として雨や雪が降ることは重要と考えています）。このようなときは、曇りや晴れを１つのマークで表示することになり、この場合に表示するマークは予想される時間が長い方となります。天気予報のマークだけでは天気予報を十分に表現できないことがありますので、詳細な天気変化については天気予報文や地域時系列予報をご利用ください。
今日、明日、週末の天気を教えて下さい。	メールでは、天気予報の内容の問合せに対する回答は行っておりません。気象庁ホームページに最新の予報を掲載していますのでご利用ください。
山沿い、山地、山間部、山岳部の違いは何ですか？	気象庁で用いる「山地」「山沿い」「山間部」「山岳部」の違いは、天気予報等で用いる用語（地域に関する用語）をご覧ください。
地域時系列予報は、対象地域をどのように決めているのですか？また、３時間ごとの天気・風・気温は、どの地域を予想したものですか？	地域時系列予報の対象地域は、天気予報の対象地域と同様で、府県予報区をいくつかに分けた一次細分区域ごとに発表しています。天気については、対象とする一次細分区域内で３時間ごとの卓越する天気を、風については、対象とする一次細分区域内の３時間ごとの代表的な風向・風速を予想したものです。また、気温については、一次細分区域内の特定の地点を予想したものです。詳しくは、地域時系列予報をご覧ください。
もっと地域を細分化した天気予報はありませんか？	気象庁発表の天気予報は長年、府県内を同じような天気が現れやすい地域を定めて発表しています。府県内の広域的な予報を知りたい場合は気象庁の予報を、特定の地域の予報を知りたい場合は気象庁長官の許可を受けた民間気象会社や報道機関等が発表する予報を、用途に応じて使い分けてください。また、気象庁ホームページでは、より詳細な地域の天気傾向を示す、約２０km四方のメッシュで表現した天気分布予報を発表していますのでご利用ください。
天気分布予報で「天気」では「雨」の区域にもかかわらず、「降水量」では「降水なし」となっている場合がありますが、どうしてですか？	天気分布予報は２０km四方のマス目に分けて、そのマス目の代表的な天気や降水量を予報しているものです。それぞれのマス目の天気は、３時間に１ミリ以上の雨がそのマス目の半分以上の面積で降ると予想される場合に「雨」と表現しています。一方、マス目の降水量は、そのマス目で予想される平均降水量を計算しており、１ミリ未満の場合は「降水なし」と表現しています。そのため、マス目の中の半分で３時間に１ミリの雨が降り、残り半分には雨が降らないと予想した場合、そのマス目の天気は「雨」と表現されますが、そのマス目の平均降水量は１ミリに満たないため、「降水なし」と表現されます。　天気が「雨」で降水量が「降水なし」という矛盾した表現に見えることは、このような弱い雨が予想されるときに限って起きますので、このような予報の場合は、「３時間に１ミリ前後の弱い雨が降る予想となっている」とご理解ください。
週間天気予報で冬は県を２地域に分けて表示していたのに、春になったら地域を分けて表示しないのはなぜですか？	府県週間天気予報は通常、府県を１つの単位として代表的な地点を定めて発表しています。しかし、冬になり冬型の気圧配置が強まると、同じ県内でも北部は雪、南部は晴れのように大きく天気が異なる日が出てきます。このため、冬季を通して府県を２細分して発表する府県があります。４月になると府県週間天気予報の細分がなくなったように見えますが、冬季のみ２細分しているためです。
週間天気予報が外れることがありますが、なぜですか？	こんにちは！天気相談所です！　第１回「週間予報では傘マークついていなかったのに！」をご覧ください。
週間天気予報はよく外れるので、３日先くらいの予報だけで良いのではないですか？	予報する時刻・日が先になるほど予報の精度が低くなるため、今日、明日の予報と比較して週間天気予報の精度は低くなります。一方で、週間天気予報よりさらに長い予報を要望される方も多くおられます。気象庁では、降水の有無について「予報が適中しやすい」ことと「予報がかわりにくい」ことの信頼度を示す情報を日々の週間天気予報に付加しております。予報の信頼度が高い順に、Ａ、Ｂ、Ｃの３段階で発表していますのでご利用ください。また、予報精度の改善に努めておりまして、週間天気予報についても少しずつではありますが精度が向上しています。
予定を立てるために、週間天気予報をもっと先まで出せませんか？	予報する時刻・日が先になるほど予報の精度が低くなるため、１週間より先の天気予報は、現在の技術では日々の天気予報として発表するために必要な精度が確保できないのが実情です。
天気予報がころころ変わる原因は何ですか？	天気予報は、地球を取り巻いている大気の将来の状態をコンピュータで計算した結果を基に、予報官が実際の天気状況と比較し、過去に得られた様々な知見に基づく修正を加えて発表しています。地球大気は「流体」であり、コップの水の一部をかき回すと、その動きはやがてコップの中の水全体に伝わりますが、それと同じように地球大気も全体が一体であるのと同時に、全ての部分が互いに影響し合っており、日本付近の天気を正しく予想するためには地球全体の大気の将来の状態を計算する（これを数値予報と呼びます）必要があります。これには膨大な計算が必要になります。数値予報は、ある時点の地球大気全体の状態（気圧、気温、水蒸気量、風）をなるべく正確に把握（観測資料の収集）したデータを用いて将来の状態を計算するのですが、その結果には必ず誤差が含まれており、時間が経過するにつれて（遠い将来ほど）その誤差は大きくなります。この誤差をなるべく小さくするために、気象庁では１日４回、地球全体の観測結果に基づく数値予報を行い、最新の結果を用いて天気予報を発表していますが、その結果、最新の天気予報の内容が過去に発表した予報と変わることは少なからずあります。天気予報は毎回変わる可能性があるものとご理解の上、ご利用ください。
天気予報が外れるのは、コンピュータや気象衛星など機械に任せきりにして、予報官が検証していないからですか？	気象庁が発表している天気予報は、地球を取り巻いている大気の将来の状態をコンピュータで計算した結果を基に、予報官が実際の天気予報と比較し、過去に得られた様々な知見に基づく修正を加えて発表しています。さらに、日々発表した天気予報の検証を行い、精度向上に努めています。検証結果は毎月、予報精度の検証結果で公開しております。降水の有無の精度や最高・最低気温の誤差については、少しずつでありますが改善を続けております。
天気図の更新にかなり時間がかかるのはなぜですか？	天気図を作成するためには、日本国内だけでなく、近隣の諸外国や航行中の船舶から送信される観測データが不可欠です。このような観測データの送信は国際的な取り決めにより、世界各国で同時に３時間ごとに行われておりますので、気象庁では１日に７回（３、６、９、１２、１５、１８、２１時）、３時間ごとに天気図を作成しています。
過去の天気図を最大１週間位見えるようにならないですか？	気象庁では速報的に行った解析結果を実況天気図として気象庁ホームページに掲載しています。その後、遅れて入ったデータも加えて解析をやり直し、最終的に確定した天気図を気象庁天気図として公表しています。日々の天気図は気象庁天気図の一部を抜粋したものです（公表は翌月２５日頃）。当初気象庁ホームページに速報的に掲載した天気図は、このように後日修正されるため、混乱を防ぐ目的で長期間の掲載を行っていません。
テレビの天気予報で表示される「上空○○mで氷点下○○℃の寒気」の地図は気象庁ホームページに掲載されていますか？	例えば「降れば雪になる上空○○mで氷点下○○℃の寒気」は、上空約1500mや約5000mのことと思われます。気象庁では、上空の気温などを示す高層天気図を作成しています。高層天気図のページで「アジア850hPa・700hPa高度・気温・風・湿数天気図(AUPQ78)」をクリックすると、上下２段の高層実況図が表示されます。下段が上空約1500mの実況図で、等気温線を破線で表示していますので、○○℃の寒気が日本のどの辺りに入っているかを確認できます。また、上空約5000mの場合は、同じページで「アジア500hPa・300hPa高度・気温・風・湿数天気図(AUPQ35)」をクリックすると、下段が上空約5000mの実況図になり、等気温線を破線で表示しています。予想は数値予報天気図をご覧ください。
平年並、冷夏、暖冬とは何ですか？	天候に関する実況や予報について表現する時に、気温や降水量などを「低い（少ない）」「平年並」「高い（多い）」の３階級で示すことがあります。この３つの階級に分ける区分値は、３０年間の観測値（夏の平均気温など）を小さい順に並べて、小さい方から１０番目まで（全体の３３％）が「低い（少ない）」、１１～２０番目（同３３％）が「平年並」、それ以上を「高い（多い）」、各階級の出現率が等しく３３％（１０年）となるように決めています。現在の区分値は1981年から2010年までの３０年間の資料で作成した値で、区分値は１０年毎に更新しています。なお、この区分の具体的な値は当然のことながら、地域により、また夏と冬でも異なります。　「冷夏」や「暖冬」は、これらの階級を用いた表現です。「冷夏」とは、夏（６～８月）の平均気温が３階級表現で「低い」場合、「暖冬」とは、冬（１２～２月）の平均気温が「高い」場合を指しています。また、これらの反対は、「暑夏」と「寒冬」です。
気象庁ホームページでは、冷夏、暖冬といった予報をどこで知ることができますか？	季節予報は、冷夏（夏平均気温が低い）や暖冬（冬平均気温が高い）となる可能性を確率で予報しています。１か月予報は毎週木曜日、３か月予報は毎月２５日頃、寒候期予報、暖候期予報はそれぞれ９月と２月の３か月予報と同時に発表し、それらの予報は、「季節予報」に掲載されます。季節予報は、直近の気象状況を反映させて定期的に更新しますので、ご利用の際は最新の情報をご確認ください。発表の年間スケジュールは「季節予報の発表日」をご覧ください。
季節予報を確率で発表するのはなぜですか？	予報期間が長くなる季節予報では、予測誤差が時間の経過とともに大きくなり３階級のどれかが実現すると断定的に予報できないため、３階級のそれぞれが実現する可能性を予測しています。　季節予報では、気温、降水量、日照時間等を、「高い(多い)」、「平年並」、「低い(少ない)」の３階級に区分し、それぞれの出現する可能性を確率で予報しています。詳しくは、季節予報における確率表現をご覧ください。
季節予報はどのように予想しているのですか？	季節予報の詳しい説明は「季節予報って何？」をご覧ください。また、併せて「季節予報に関するＱ＆Ａ」もご覧ください。
季節予報等の気候情報は、どのように利用すれば良いですか？	「気象情報を活用して気候の影響を軽減してみませんか？」をご覧ください。
台風の番号はどういう順番で付けるのですか？	毎年１月１日以後、北西太平洋で最も早く発生した台風を第１号とし、以後台風の発生順に番号を付けています。
台風の英語名は今でも使われていますか？	北西太平洋領域に発生する台風の呼名として、１９９９年までは米国が英語名を用いていましたが、これに代わり2000年１月１日からアジア名を用いることとなりました。台風の名前については、台風の番号の付け方と命名の方法をご覧ください。
台風のアジア名は変更されることがありますか？	台風のアジア名は繰り返して使用されますが、大きな災害をもたらした台風などは、その名前を以後の台風に使用しないように変更することがあります。具体的には、北西太平洋及び南シナ海における台風防災に関する政府間組織である台風委員会の加盟国からの変更要請を受けて台風委員会が名前を変更します。台風の名前については、台風の番号の付け方と命名の方法をご覧ください。
台風の大きさ、強さの定義は？	台風の大きさは、風速１５m/s以上の強い風が吹くおそれがある範囲を台風の中心からの半径で表して定義しています。台風の強さは、最大風速の大きさで分類しています。台風の大きさと強さの階級は、台風の大きさと強さをご覧ください。
台風は中心に近いほど雨が強いのですか？	台風による雨は中心ほど激しいとは限らず、かなり離れた場所でも雨に対する警戒が必要です。台風に伴う雨の特性をご覧ください。
台風にはどうして前線がないのですか？	前線は暖かい空気と冷たい空気の境目です。熱帯や亜熱帯で発生・発達する台風の中心付近は大量の水蒸気を含んだ暖かい空気でおおわれていますので、前線はありません。一方、暖かい空気と冷たい空気の境目にできるのが温帯低気圧です。台風が温帯域まで進んできて、冷たい空気が台風の中心付近に入り込み出すと台風は温帯低気圧の性質を持ち始め、台風の中心までに前線が達すると、台風から温帯低気圧に変わったことになります。
台風予報はどの範囲を担当しているのですか？	日本の気象庁は赤道以北、北緯６０度まで、東経１００度から１８０度までの範囲にある台風の位置決定及び予報について担当しています。
台風とハリケ－ンとサイクロンの違いは何ですか？	台風は、東経１８０度より西の北西太平洋および南シナ海に存在する熱帯低気圧のうち、最大風速が約１７m/s以上になったものを指します。ハリケーンは、北大西洋、カリブ海、メキシコ湾および西経１８０度より東の北東太平洋に存在する熱帯低気圧のうち、最大風速が約３３m/s以上になったものを指します。サイクロンは、ベンガル湾やアラビア海などの北インド洋に存在する熱帯低気圧のうち、最大風速が約１７m/s以上になったものを指します。　このように、それぞれの名称を付している最大風速の基準には違いはありますが、台風もハリケーンもサイクロンもそれぞれの地域に存在する熱帯低気圧を強さによって分類している用語の１つということになります。なお、サイクロンは熱帯低気圧と温帯低気圧の区別をせず、広く低気圧一般を指す用語としても用いられることがあります。
海上の台風の中心気圧はどのように測っていますか？	台風が海上にある場合は、島や船舶などの観測結果と気象衛星で観測した画像を用いた解析を行って中心気圧などを決めています。気象衛星で観測した画像による台風の解析では、眼の有無や形、中心付近の発達した雲の形や大きさ、雲の温度などから、台風の強度（中心気圧と風速）を統計的に導き出す方法を使っています。
海面水温が高いと台風が発生するのですか？	よくある質問集（海洋について）をご覧ください。
台風の進路に関係する偏西風の状況が分かるページはありますか？	台風の進路に影響を及ぼすような「偏西風」の実況や予想は、気象庁ホームページに最新の図を掲載しており、１２時間ごとに更新しています。実況は、高層天気図をご覧ください。偏西風の位置は、高層天気図で帯状に風速の大きい領域に対応します。例えば200hPa（上空約１２km）の天気図を表示するには、９時のものは「00UTC」を、２１時のものは「12UTC」をクリックしてください。200hPaの等高度線が実線で、等風速線が破線で示されています。また、矢印でジェット軸が示されており、これが偏西風の位置ととらえれいただければと思います。詳細は、高層天気図についてをご覧ください。予想は、数値予報天気図をご覧ください。250hPa、300hPa、400hPa、500hPaの２４時間後の風速分布予想図があり、参考になると思います。
冬や春に日本付近で急速に発達する低気圧を台風と呼ばないのはなぜですか？	熱帯の海上で発生・発達した台風と、暖かい空気と冷たい空気の境目で発生・発達する温帯低気圧は全く異なる構造を持ち、強い風が吹く場所や強い雨が降る場所の特徴も異なります。冬や春に日本付近で急速に発達する低気圧は、温帯低気圧ですので台風ではありません。急速に発達する低気圧は、暴風や高波、大雨や大雪などの災害が予想されるため、気象情報や警報・注意報などで危機感を伝える様々な工夫をしています。（参考）雨と風（雨と風の階級表）[PDF形式]
今後北上する台風の進路はどうなりますか？　日本に上陸しますか？	最新の予報をご利用頂きたいと思いますので、メールでの回答は行っておりません。台風情報をご覧ください。
台風が温帯低気圧になった途端に台風情報を終了するのはなぜですか？	台風が温帯低気圧になっても強風や大雨による大きな影響が続く場合は、台風情報を終了した後も強風や大雨、高波などに関する警報や注意報、気象情報等を発表しています。台風の一般的な特徴は、中心付近で風が強いこと、台風の中心を取り巻いて発達した雨雲が存在することです。一方、温帯低気圧の特徴は、広い範囲で風が吹くこと、前線に沿うなどして発達した雨雲がひろがっていることなどです。台風が温帯低気圧に変わった場合は、低気圧の位置よりも強風や大雨、高波などが予想される場所が重要ですので、各地の気象台が発表する警報や注意報、気象情報などに留意してください。
降水量とは何ですか？　降水量を「ミリ」で表すのはなぜですか？	降水量は、降った雨がどこにも流れ去らずにそのまま溜まった場合の水の深さで、mm（ミリメートル）で表しています。例えば、「１時間で100ミリの降水量」は降った雨がそのままたまった場合、１時間で雨が水深１０cmとなるということです。１平方メートルに100ミリの雨が降った場合、水の量は100リットル（重さにして約100kg）になります。
降水量は、いつ降った雨の量ですか？	降水量は、観測時刻までの一定の時間（１時間、１０分間など）に降った雨の量を表します。なお、アメダスのページでは前１時間の降水量を示しており、「１２時の降水量」として表示されている数値は、１１時００分から１２時００分までの降水量です。
降水量の単位は「ミリメートル」なのに「メートル」を省略して「ミリ」と言っているのはなぜですか？	気象庁では、風速の単位は「m/s（メートル毎秒）」、降水量の単位は「mm（ミリメートル）」を用いており、統計資料を示す場合は、正確な単位表現を用いています。一方、気象情報では、社会一般での使われ方や字数制限のある情報内での利用を考慮して、風速の単位の「メートル毎秒」を「メートル」、降水量の単位の「ミリメートル」を「ミリ」とするなど、一部を省略した単位表記を行っています。これらの表記は、誤解されることがないよう、報道機関などのご意見を聞いて決めています。
簡単に降水量を測る方法はありませんか？	開口部から底面までの面積が同じ容器（筒状の容器）であれば、その観測期間ごとに溜まった雨水を、ものさしで測ることにより観測できます。また、ペットボトルで雨量計を製作する方法を次の気象台ホームページで紹介しています。　神戸地方気象台ホームページ「ペットボトルを使ってかんたんな雨量計を作ってみよう！」　徳島地方気象台ホームページ「工作コーナー」
集中豪雨はなぜ発生するのですか？	集中豪雨は、活発な積乱雲がもたらします。活発な積乱雲の発生に共通した気象条件としては、大気の状態が不安定である、すなわち、地表面付近の空気が比較的暖かく湿っており、上層の空気が比較的冷たく乾いている状況です。梅雨前線や太平洋高気圧の縁、台風の周辺などにおいては、多量の水蒸気が継続して流入することがあり、大気の状態が不安定となって集中豪雨が発生することがあります。また、地形の影響を受けて、水蒸気がある狭い地域に集まることが集中豪雨を引き起こす原因となることもあります。　集中豪雨をもたらす、個々の積乱雲の寿命はせいぜい１時間程度です。しかし、積乱雲が同じような場所で、あたかも世代交代をするように次々と発生→発達→衰弱を繰り返して、激しい雨が数時間から十数時間も継続することがあります。　最近の予報技術の向上に伴って、集中豪雨のおおよその発生の場所や時間、量などを１日から半日くらい前に予想することが可能な場合も出てきました。気象庁ではスーパーコンピュータを使った数値予報に加えて、気象衛星やレーダー、アメダス、ウインドプロファイラなどの観測資料などを用いて、集中豪雨をもたらす現象を常時監視しており、集中豪雨の兆しを捉えた場合には、発生が予想される場所や時間をできるだけ絞り込んで、大雨警報として発表しています。
「激しい雨」、「猛烈な雨」とは、どのくらいの雨を指すのですか？	気象庁では、国民の皆様に雨の強さの程度を容易にご理解いただくために、雨の強さを「やや強い雨」、「強い雨」、「激しい雨」、「非常に激しい雨」、「猛烈な雨」の５段階に分類してお伝えしています。例えば「激しい雨」とは１時間に30ミリ以上50ミリ未満の雨でバケツをひっくり返したように降るイメージ、「猛烈な雨」とは、１時間に80ミリ以上の雨で息苦しくなるような圧迫感がある。恐怖を感ずるイメージとなります。詳しくは、雨の強さと降り方を参照してください。
落雷、ひょうはどのような気象状態のときに発生するのですか？	落雷やひょうは、発達した積乱雲にともなって発生します。発達した積乱雲の中では、上空の雲の中に浮かんでいる細かい氷の粒（氷晶）とあられが衝突する際に電荷が発生する説が最近の研究では有力とされています。そして、雲の中ではプラスとマイナスの電荷が分かれて分布するようになります。空気は通常は絶縁状態で電気を通さないのですが、電荷がだんだんと蓄積されてある限度を超えると、絶縁状態がやぶれて雲と雲との間や雲と地上との間で瞬間的に電気が流れます。これが「雷」で、このうち雲と地上との間の雷が「落雷」です。　一方、細かい氷の粒の回りに過冷却状態（氷点下でも凍らずに液体のままの状態）の水の粒が凍りついてだんだんと大きくなると、積乱雲の中の強い上昇気流で持ちこたえられなくなります。このような氷の粒が溶けずに落下して地上へ到達するものが「ひょう」です。なお、氷の粒は地上へ落下中に大きくなることもあります。
大雨の回数は増えているのですか？	気象庁では、1901年から全国の気象台や測候所等５１箇所の降水量データを用いて日降水量100ミリ以上及び200ミリ以上の発生回数を年ごとに集計していますが、両者とも長期的には増加傾向が現れています。また1976年から全国約1300箇所のアメダスで観測された１時間降水量５０ミリおよび８０ミリ以上の発生回数も長期的には増加傾向が現れています。少しずつ増加してきており、いずれの場合でも発生数には増加傾向が見られます。詳しくは、気候変動監視レポートの第２章気候変動やアメダスで見た大雨発生回数の長期変化についてをご覧ください。
５０年に一度とされる大雨が、年に何回も降るのはなぜですか？	「５０年に一度」の表現は、気象台が抱いている危機感を皆様にお伝えするため導入しているもので、統計的にその地域で５０年に一度程度の大雨などになっていることを伝えるものです。統計値なので、一度発生すれば５０年起こらないというものではなく、２週続けて起こることもあります。また、「５０年に一度」とは地域ごとに見てのものであり、全国的に見た場合は年に複数回程度は起こりうるものです。
梅雨入り・梅雨明けを発表しているのはなぜですか？	梅雨期は大雨による災害の発生しやすい時期でもあり、一方、梅雨明け後の盛夏期に必要な農業用の水等を蓄える重要な時期でもあります。また、梅雨期は曇りや雨の日が多くなって、日々の生活等にも様々な影響を与えることから社会的にも関心が高い時期でもあります。このため、気象庁では、現在までの天候経過と一週間先までの見通しをもとに、梅雨の入り・明けの速報を「梅雨の時期に関する気象情報」として発表しています。
梅雨入り・梅雨明け日の末尾に「・・ごろ」と付けるのはなぜですか？	気象庁では梅雨を「晩春から夏にかけて雨や曇りの日が多く現れる期間」と定義しており、季節が移り変わる中で現れる季節現象の一つとして捉えております。「今日から梅雨」、「今日から梅雨明け」などとある１日を特定することは難しく、平均５日間程度の移り変わりの期間があることから、梅雨入り・梅雨明け日の末尾に「・・ごろ」と付けています。
梅雨入り・明けを発表する地域が現在のように区分けされているのはなぜですか？都府県別に梅雨入り・梅雨明けの発表はできませんか？	天気予報や各種の気象情報は、注目する現象の時間・空間スケールに適合した領域を考慮して発表しています。梅雨は1ヶ月余りに及ぶ時間スケールを有し、梅雨前線や太平洋高気圧の動向など広い範囲での平均的な状態に依存する季節現象であることから、日々の天気予報より広い地域を単位として現象の経過を監視しています。このため梅雨入り・梅雨明けの発表では、都道府県単位より広い範囲の地域特性を考慮し、全国（梅雨のない北海道を除いて）を12のブロックに分けた地域を発表対象としています。　同一ブロック内でも、さらに細かな地域特性もあり、ブロック全体としては梅雨の天気の状況となっていても、ブロック内のある都道府県では梅雨らしくない好天が続く場合もあります。一方で、季節現象としての梅雨入り、梅雨明けの発表は、平均５日間程度の移り変わりの期間を考慮した予想を元にしているため、その時間スケールに見合う広がりで判断する必要があり、都道府県別ではなく、現在のブロック分けが適切と考えています。都道府県別程度の広がりの天気変化については、天気予報や週間天気予報の利用をお願いします。
梅雨入り・梅雨明けの発表は早すぎた（遅すぎた）場合、梅雨入り・梅雨明けの期日を見直すことはありますか？	梅雨入り・明けの速報とは別に、春から夏にかけての実際の天候経過を考慮した検討を行い、９月はじめに梅雨入り・明けの確定を行います。その結果、速報で発表した梅雨入り・梅雨明けの期日と異なる場合があります。
小笠原に梅雨はありますか？	小笠原諸島では５月中旬から６月上旬頃にかけての２、３週間程度、降水量が増え、日照時間が減る期間があります。しかし、この時期の小笠原諸島は太平洋高気圧の影響を強く受けるため、太平洋高気圧の動向によっては、そのような雨が多い期間がほとんど現れない年もあります。他の地方での梅雨の期間は６週間程度ですが、それらに比べて期間が短く、例年現れる現象でもないことから、気象庁では季節現象として扱いことは難しいと判断して、梅雨入り・梅雨明けの発表は行っていません。
北海道に梅雨がないのはなぜですか？	梅雨前線が北上する過程では北海道付近まで近づくことがあり、そのときには北海道地方でも梅雨のような天気になり、大雨となることがあります。この状態が「えぞ梅雨」と呼ばれることがありますが、この状態は毎年のように出現しないことから、北海道地方では「梅雨に関する気象情報」を発表していません。
梅雨前線が原因でない雨なのに、梅雨明けしないのはなぜですか？	気象庁では「梅雨」を「晩春から夏にかけて雨や曇りの日が現れる現象、またはその期間」と定義しています。このため、梅雨前線が原因でない雨であっても雨が続く場合は梅雨明けとなりません。
人工降雨は、どのように行うのですか？	人工降雨といっても、全く雲のないところから雨を降らせるのは無理で、雲のあるところに雨粒の核になるもの（ヨウ化銀など）を蒔き、雨を降らせます。現在のところ、水不足を解消できるほど雨を降らせることはできません。
雪はどうしてできるのですか？	雪は、ちり、ほこりなどを核として、大気中の水蒸気が凍って氷の結晶になることによってできます。氷の結晶にさらに水蒸気が凍ってくっついて成長し、雪の結晶ができあがります。この雪の結晶が地上に落ちてくる途中で水滴になったものは雨となりますが、とけずにそのまま落ちてきたものは雪となります。
雪の色はどうして白いのですか？	光には電波のように波長があり、物体によっては吸収する波長と反射する波長が異なるため、さまざまな色に見えます。雪の結晶の一つひとつは透明ですが、細かい結晶が折り重なると、光の乱反射効果によって白く見えるようになります。
初雪とは何ですか？	気象庁における初雪とは、寒候年（前年８月から当年７月まで）に初めて降る雪（みぞれを含む）です。
初冠雪（はつかんせつ）とは何ですか？	雪やあられなどが山頂付近に積もり、白く見えることを冠雪といいます。寒候年（前年８月から当年７月まで）に、付近の気象台から初めて見えたときを、その山の初冠雪といいます。
日本海側に雪が多いのはどうしてですか？	冬になると、日本付近にはシベリア大陸で発達した高気圧から、北寄りの冷たく乾いた季節風が吹きやすくなります。この風が比較的温かな日本海をわたってくる途中で、水蒸気の補給を受けて雪雲ができ、日本海側は雪が降ります。雪雲が日本列島の中央の山脈を越える時に、ほとんどの雪は落ちてしまい、太平洋側では晴れとなります。
山雪、里雪とは何ですか？	山雪と里雪は、日本海側の降雪の特徴を表現する言葉で、山間部を中心に大雪になる場合を山雪型の大雪、海岸や平野部を中心に大雪となる場合を里雪型の大雪と呼んでいます。山雪型の大雪は、西高東低の冬型の気圧配置が強まって等圧線がほぼ南北に縦じま模様になり、衛星画像では雪雲が北西から南東に筋状に並ぶときにおこります。このような場合、北西の強い季節風が日本列島の高い山々に吹き付けるため、山の風上側で雪雲が発達して大雪をもたらします。里雪型の大雪は、冬型の気圧配置が弱まって等圧線の間隔が広がり、上空に強い寒気が流れ込んで大気の状態が不安定となったときに起こります。このような場合、海岸沿いで雪雲が発達し、海岸や平地に大雪をもたらします。一方で、山に吹き付ける風は弱いため、山間部での雪雲の発達は顕著ではありません。
ぼたん雪と粉雪はどうちがうのですか？	雪の粒は、大気の状態によってさまざまな形をしており、その形によって性質がちがいます。粉雪は寒く乾いたときに降ります。逆に、空気が比較的暖かく湿っているときにぼたん雪となります。ですから、粉雪は軽い雪に、ぼたん雪は重い雪になります。
「あられ」とは何ですか？	あられは、直径がおよそ２～５ミリほどの氷の固まりです。雲の中を落ちてきた雪の結晶が、下からの上昇気流におし上げられて、また落下するということを何度も繰り返しているうちに、たくさんの水の粒が凍りついて降ってくるものをいいます。あられが直径５ミリ以上のものになると、ひょうと呼ばれ、ゴルフボール大のものや、ときには野球ボールより大きいものが降ることもあります。
「みぞれ」とは何ですか？	みぞれとは、雨と雪が混じったものをいいます。上空から雪が降ってくる途中、地上近くの気温が高いと、雪がとけて雨になります。一部分とけずに雪のまま落ちてくると、みぞれになります。みぞれは、観測分類上は雪に含めます。
沖縄で雪やみぞれが降ったことはありますか？	降ったことがあります。２０１６年１月２４日から２５日にかけて、沖縄本島北部の名護と沖縄本島の西にある久米島の観測所で、みぞれを観測しました（みぞれは観測分類上、雪に含まれます）。久米島のみぞれ観測は、１９７７年２月１７日以来、２度目となり、名護のみぞれ観測は、１９６６年の観測開始以来初めての観測となりました。
雪は降水量としても観測されていますか？	雪が降った場合は、雪を雨量計で溶かして降水量として観測しています。
「風速」と「瞬間風速」は、何が違うのですか？	「風速（または平均風速）」は、１０分間の平均風速を示します。「瞬間風速」は、ある瞬間の風速を示します。「瞬間風速」は、「（平均）風速」の１．５倍から３倍程度に達することがあります。
平均風速（１０分間平均風速）は、どの１０分間を対象としていますか？	観測時刻までの１０分間の平均風速です。例えば、１５時の平均風速は、１４時５０分から１５時００分の１０分間の風速の平均です。
気象庁ホームページに記載されているアメダスの風速は１m/s単位となっていますが、四捨五入して表示しているのでしょうか？	アメダス（地図形式）の風速は、毎正時前１０分間の平均風速の小数第１位を四捨五入して表示しています。
気象庁の風向の観測の『北』とは「真北」ですか？それとも「磁北」ですか？	真北です。
「暴風」、「非常に強い風」は、どのくらいの風速のことを指すのですか？	気象庁では、皆様に風の強さの程度を容易にご理解いただくために、風の強さを「やや強い風」、「強い風」、「非常に強い風」、「猛烈な風」の４段階に分類してお伝えしています。例えば、「非常に強い風」とは風速２０m/s以上３０m/s未満の風を指します。一方で、暴風警報基準以上の風のことは「暴風」とも呼んでいます。暴風警報基準は都道府県ごとに設定しており、例えば、東京地方で「暴風」と言うのは風速２５m/s以上の風を指しています。詳しくは、風の強さと吹き方をご覧ください。
突風とは何ですか？	竜巻などの激しい突風とはをご覧ください。
竜巻はどうして起きるのですか？	発達した積乱雲の中には強い上昇気流があります。一方、周辺の風の分布や地形の影響などによって地面付近には大きな回転性の流れ（渦）が生じることがあります。この大きな渦の上に積乱雲の上昇流が重なると渦は上空に引き伸ばされ、最初は大きかった回転の半径が小さくなります。回転の半径が小さくなると回転のスピードが速くなるので、最初の渦は風速が弱くても引き伸ばされた渦の風速は非常に強くなります。これはフィギュアスケートの回転で腕をたたむと回転スピードが上がるのと同じです。このようにしてできた上下に細長く伸びた速い回転の渦が竜巻です。
「藤田スケール」とは何ですか？	藤田スケールとはをご覧ください。
風速の単位が時速（km/h）でなく秒速（m/s）なのは、なぜですか？	気象庁では、1886（明治19）年に風速を秒速（m/s）で表記するよう定めました。現在、秒速の表記は、気象分野だけではなく、風工学などの学術研究や耐風設計などの技術的な基準など、一般にも広く定着しています。なお、実際の風の強さをイメージしやすいように風の強さと吹き方という表を作成しています。
○○時の気温は、○○時の瞬間の気温ですか？	○○時の前１分間の平均気温です。例えば、「１２時の気温」として表示されている気温は、１１時５９分から１２時００分に観測された気温の平均です。
新聞に掲載されている最高・最低気温と気象庁が発表している最高・最低気温が異なるのはなぜですか？	気象状況により、最高気温が夜間に観測されたり、最低気温が日中に観測される場合があります。しかし、新聞では、例えば最高気温は１５時まで、最低気温は９時までに観測された値を掲載しているなど、１日を通しての値と異なる場合があります。このため、新聞と気象庁発表の最高・最低気温が異なることがあります。
「猛暑日、真夏日、真冬日」とは何ですか？	最高気温が３５℃以上の日を猛暑日、３０℃以上の日を真夏日、２５℃以上の日を夏日、０℃未満の日を真冬日といいます。最低気温が０℃未満の日を冬日といいます。
熱帯夜とは何ですか？	夕方から翌日の朝までの最低気温が２５℃以上になる夜のことをいいます。
フェーン現象とは何ですか？	湿潤な空気が山を越えて反対側に吹き下りたときに、風下側で吹く乾燥した高温の風のことを「フェーン」と言い、そのために付近の気温が上昇することを「フェーン現象」と呼びます。これは、湿潤な空気が山を吹き上がる時は､湿潤な空気に含まれる水蒸気を雨として降らせながら100メートルにつき0.5℃の割合で気温が下がり、逆に山を吹き下りる時は、乾燥した空気が100メートルにつき１℃の割合で上昇しながら吹き下りるために起こります。ちなみに1933年７月には、フェーン現象により山形市で40.8℃の最高気温を記録しています。
不快指数って何ですか？	気温と湿度から求められる「蒸し暑さ」の指数で、日本人の場合、不快指数８５で９３％の人が蒸し暑さのため不快感を感じるとされていますが、体に感じる蒸し暑さは気温と湿度以外に風速等の条件によっても左右されるため、不快指数だけでは必ずしも体感とは一致しないと言われています。気象庁の統計種目にはなっていません。
湿度の予報をしないのはなぜですか？	湿度は場所による偏りが大きく、例えば同じ地点でも家の中と外では異なり、草地や池の存在、風向きなどの周囲の状況によっても変わるため、湿度の予報値があっても利用は難しいと考えています。そのため、気象庁では湿度の低い状態が続くと予想される場合には乾燥注意報を発表しますが、湿度の予報はしていません。
気圧の予報をしないのはなぜですか？	気圧については、気温のようにある地点を予想するのではなく、予想天気図として地上の気圧分布の予想を発表しています。これは、気温などと違って気圧の場合は、ある地点の値ではなく、気圧がどのような分布をしているかで気象状況が表現されるという性質を持っているからです。例えば、風向きはどの方向の気圧が高いか低いかで決まりますし、風の強さは周囲での気圧の差が大きいか小さいかで決まります。　このような気圧分布を表現するために作成されているのが地上天気図です。天気図には同じ気圧の地点を線で結んだ「等圧線」が描画されており、等圧線の傾きで風向き、等圧線の混み具合で風の強さを知ることができます。また、高気圧や低気圧の位置で天気の変化を知ることもできます。天気図上のある地点の気圧を知りたい場合は、天気図の等圧線からおよその値を読み取ることもできます。地上天気図は、実況を表す実況天気図を1日7回、24時間先と48時間先を予想する予想天気図をそれぞれ1日2回気象庁ホームページに掲載しています。
気象庁ホームページに掲載されている気圧は、海面気圧と現地気圧のどちらですか？	アメダス（表形式）では、気象台等で観測した海面気圧を掲載しています。海面気圧とは、海面上（0ｍ）に校正した気圧です。現地気圧（観測所で観測された気圧）は標高が高いほど小さくなるため、現地気圧の数値をそのまま使用して天気図を書くと、ほとんど等高線のようなものになってしまいます。このため、天気図を書く際には海面気圧を使用していますが、これにあわせて気象庁ホームページでは海面気圧を掲載しています。なお、標高の高い日光、軽井沢、富士山、河口湖、阿蘇山は現地気圧で表示しています。これら高所の観測所では海面気圧への校正を十分な精度で行うことができないことから、このような表示としています。また、過去の気象データ検索では、海面気圧と現地気圧の両方を掲載しています（ただし、上述の標高の高い地点を除く）。
気圧の単位は、いつから「mb（ミリバール）」から「hPa（ヘクトパスカル）」に移行したのですか？	世界的なSI単位系（国際単位系）への移行にあわせ、平成４年（1992年）１２月１日に気圧の単位をmbからhPaに移行しました。航空気象業務では、それ以前よりhPaを使用していました。なお、mbとhPaとは数字的に同数です。
気象庁ホームページに掲載されている日照時間の表示はいつのものですか？	例えば「１２時の日照時間」として表示されている数値は、１１時００分から１２時００分までの間に観測された日照時間の値です。
日照時間の定義は？	日照時間とは直射日光が地表を照射した時間です。現在、日照は、「直達日射量が0.12kW/㎡以上」として定義しています。
晴れと曇りの違いは何ですか？	全天を覆う雲の量（雲量）が９割以上の場合は曇り、雲量が２割から８割までの場合は晴れ、雲量が１割以下の場合は快晴です。
空はどうして青いのですか？夕焼けはどうして赤いのですか？	太陽光は、人間の目で感じることができる様々な色（波長の短い方から順番に、むらさき、青、緑、黄、だいだい、赤）の光を含んでいます。晴天時には、太陽光は地球の大気を通る時に空気分子によって散乱されますが、空気分子の大きさは光の波長に比べて非常に小さいので、波長の短い光がより強く散乱されます。波長の一番短い紫色の光は、空の高いところで散乱されてしまい、地上に届く量は少なくなってしまいます。このため、晴天時の空を見ると、強く散乱された波長の短い光のうち、地上に届く量が多い青色の光が強調されて、青く見えることになります。また、夕方は太陽が地平線に近いので、太陽光が大気を通過する距離が長くなり、波長の短い光は途中で散乱されてしまい、波長の長い赤色の光が多く地上に届きます。このため、夕焼けは赤く見えます。
雲の色が変化するのはなぜですか？	雲がある時、太陽光は雲により散乱しますが、雲粒の大きさは光の波長と同程度で、散乱の強さは波長によらないため、特定の色の光が強く散乱されるということがなく、雲は白く見えます。天気の悪い日には、雲が厚く太陽光が雲の底まで届かないため、暗い色（グレーや黒）に見えます。ただし、この時も、雲の上は真っ白に輝いています。また、霧やもやが白く見えるのも、大気中に漂う小さな水滴により、同じ原理で太陽光が波長によらずに散乱されることが原因です。
虹はどうしてできるのですか？	虹は太陽光が空気中の水滴で、屈折（折れ曲がる）・反射（はね返る）して起きる現象です。太陽光が反射して起こる現象ですから、虹は必ず太陽を背にした方向に現れます。虹は鮮やかに見える場合とぼんやりしか見えない場合があります。それは、空気中の水滴の大きさに関係しています。水滴が大きいほど、色がくっきりみえます。普通の虹は、外側が赤、内側がむらさきと決まっています。虹の外から内側にかけて、赤、だいだい、黄、緑、青、むらさきとなります。虹ができるには太陽光が空気中の水滴（雨）に当たることが条件となります。雪は固形物ですから水滴のように、太陽光が屈折や反射することができないため雪が降っている時や雪が降った後では、虹はできません。
虹は何色ですか？	虹は太陽光が空気中の水滴で、屈折（折れ曲がる）・反射（はね返る）して起きる現象です。虹が７色（６色）に見えるのは、太陽光線（可視光線）が７色(６色）に分解されるためです。これにより、虹の色は６色とも、７色ともいわれています。太陽光(可視光線）をプリズムで分解すると、６色(理科年表から）でその内訳は赤、だいだい、黄、緑、青、むらさきとなるため、虹の色は６色といわれています。可視光線の色の境界には個人差があるため、ここでは虹の色は６色としていますが、青色の次に「藍色」を加えた７色ともいわれていることがあります。
太陽の横に虹が出ていたのですが、これはどういった現象でしょうか？	虹のようなものは、”暈（うん、かさ、ハロー）”および”幻日（げんじつ）”と呼ばれる大気光象（太陽光や月光が屈折や反射をして生ずる現象）です。暈は、氷晶（こまかい氷の粒）からなる上層雲が現れたときに、太陽や月の回りにできる光の輪のことです。この光の輪は、太陽や月を中心としてできる視半径22°と46°の比較的大きいもので、上層雲中に含まれる氷晶による光の屈折が原因でできます。視半径22°のものを内暈といい、視半径46°のものを外暈と言います。内暈も外暈ともに屈折率が小さい赤色が内側、紫色が外側となります。また、幻日は内暈（自分から見て太陽となす角度が22°の位置に生じる暈）の左右にできる明るく色づいた光点で、こちらも氷晶による光の屈折でできます。
雲が七色に見える「彩雲」の仕組みは何ですか？	彩雲は、上空の比較的薄い雲がその縁に沿うように赤、黄、緑などの色に分かれて見える現象です。この現象は、太陽の光が雲の粒を回り込んで進む（これを回折といいます）ことにより発生します。この際に波長が長い赤い光は波長の短い青い光より大きな角度で雲の粒を回り込むため、光の色によって進行方向が変わり、色が分かれて見えるようになります。また、雲の粒の大きさにより光の回り込み方が異なることから、雲の粒の大きさで雲の色が違って見えます。一般に雲の縁で雲の粒が最も小さく、中心に向かって雲の粒が大きくなりますので、雲の縁から中心に向かって色が変わって見えるわけです。
太陽の回りに虹の様な丸い円がありました。あれは何ですか？	太陽付近に上空の薄い雲がかかっている場合、光が上空の薄い雲の中にある氷の粒に反射・屈折して起こる「日暈（ひがさ）」という現象です。
降水量はどのように観測しているのですか？	転倒ます型雨量計で観測をしています。この雨量計の中には、転倒ますという左右に２個の三角形の「ます」を取り付けたものが収まっています。口径２０cmの受水器で雨水受けた雨水が一方の転倒ますに一定量溜まると、転倒ますが転倒し、転倒ますを支えている軸上にある磁石がリードスイッチの前を通るようになっています。この時リードスイッチが一定時間ONとなり、電気信号が出力されます。その転倒した際に出た電気信号は、雨量計とは別の場所にある処理装置などに送られ時間毎に合計された降水量を求めています。気象庁で使用している転倒ます型雨量計の「ます」の容積は０．５ミリ相当となっており、転倒ます１回の転倒で０．５ミリ、２回の転倒で１ミリの降水量を観測したことになります。
アメダスが設置されていない場所での降水量は、どうしたらわかりますか？	降水の強さの分布は、気象レーダー、高解像度降水ナウキャストのページを、降水量の分布は解析雨量のページをご覧ください。また、国土交通省の防災情報提供センターでは、関係機関や都道府県が河川管理や道路管理、砂防対策のために設置している雨量観測施設の観測値を見ることができます。
気温はどこで、どのように計測しているのですか？	気温の観測は、風通しや日当たりの良い場所で、電気式温度計を用いて、芝生の上１．５mの位置で観測することを標準としています。また、電気式温度計は、直射日光に当たらないように、通風筒の中に格納しています。通風筒上部に電動のファンがあり、筒の下から常に外気を取り入れて、気温を計測しています。
気象レーダー、ウィンドプロファイラ、ラジオゾンデとは何ですか？	気象レーダー、ウィンドプロファイラ、ラジオゾンデによる高層気象観測をご覧ください。
低い雲が広がり、時々細かい雨が降っていますが、レーダーに映らないのはなぜですか？	気象レーダーで観測している高度は、一般的な雨雲がよく観測できる高度約２kmに設定しており、それより低い高度のみに雨雲が存在している場合は、十分に捉えられないことがあります。また、細かい雨から反射される電波は非常に弱く、他の要因で反射された電波（ノイズ）との区別が困難なため、雨として検出できない場合があります。　気象庁ホームページには、雨量の分布の情報として解析雨量があります。解析雨量は気象レーダーによる観測をアメダスなどによる観測で補正することで、正確な雨量を把握できます。
高解像度降水ナウキャストやレーダー画像でリング状の強い降水域が見えますが、何ですか？	雪が落ちてくる途中で融けて雨に変わるところ（融解層）ではレーダーの電波が強く反射されるため、実際よりも強い降水として観測されます。この現象をブライトバンドと呼びます。ブライトバンドはレーダーを中心としてリング状に現れます。詳しくは、高解像度降水ナウキャスト（よくある質問集）のページの雨域の表示についてまたは気象レーダーのページの気象レーダーを利用する際の注意事項をご覧ください。
静止気象衛星はどうして宇宙空間の同じ場所にいることができるのですか？	静止気象衛星は、宇宙空間の同じ場所に留まっているわけではなく、赤道上空約36,000kmの円軌道を周回しています。この高度では、衛星に働く地球の引力と、衛星が一日に一回地球の周りを回ることによって生じる遠心力とが釣り合います。衛星は、地球の自転と同じ一日一回の周期で地球の周りを回るので、地球から見ると常に同じ場所に留まっているように見えます。もし、例えば、この高度よりも地球に近いと、地球の引力が強くなるので、この引力と釣り合う遠心力を得るためには、もっと速いスピードで地球の周りを回る必要があります。この場合、衛星はどんどん東へ移動してしまうことになります。
静止気象衛星「ひまわり８号・９号」の画像の分解能は？	静止気象衛星「ひまわり８号・９号」の分解能は、画像の種類により異なります。衛星直下点での水平分解能は、最も細かいもので可視画像０．５km、赤外画像２kmとなっています。
気象衛星の愛称はなぜ「ひまわり」なのですか？	はれるんライブラリー　なぜ静止気象衛星の愛称は「ひまわり」になっているの？をご覧ください。
気象衛星の写真に映らない雲はあるのですか？	はれるんライブラリー　静止気象衛星で見えない雲はあるの？をご覧ください。
地球を観測する以外にどんな機能があるのですか？	はれるんライブラリー　地球を観測する以外にどんな機能があるの？をご覧ください。
気象衛星は雲の状況を知るほかに、何に使われていますか？	静止気象衛星「ひまわり」は、雲の様子を観測する以外に、海氷などの分布や海面・地面の温度などを観測しています。また、画像を処理することで火山の噴煙の様子もわかります。さらに、衛星で観測した雲の動きから上空の風向・風速を計算し、数値予報（コンピューターによる天気予報）のデータ としても利用しています。　「ひまわり」で観測されたこれらのデータは、日本だけでなく、東アジアや、オセアニア、西太平洋の多く の国々でも利用されており、台風や集中豪雨に関する防災気象情報の精度向上に役立っているほか、気候変動の監視、船や飛行機の安全な運航に貢献しています。　また、「ひまわり」には、船や飛行機、山岳地帯、砂漠、離島などに設置された観測装置から送られる気象観測データや潮位（津波）データなどを集めて気象庁に送る機能があり、これにより集められたデータも、日本を含む各国の気象や津波の監視などに大きく貢献しています。
衛星の寿命はどれくらいですか？	はれるんライブラリー　衛星の寿命はどれくらい？をご覧ください。
気象庁ホームページで過去の観測データや平年値を閲覧できますか？	地点ごとの気象観測データや平年値の閲覧は、過去の気象データ検索のページをご利用ください。このページでは、都府県（北海道は地方）・地点、年月日、「データの種類」を選択することにより、一覧表形式で閲覧することができます。 　一方、地域平均気象データの閲覧は、過去の地域平均気象データ検索のページをご利用ください。このページでは、全国の地域（北日本、東日本、北海道、東北、北陸など）における平均値（ただし、対象となるのは平年差や平年比といった平年値との比較結果のみです）を閲覧することができます。
気象庁ホームページで今日の観測データを閲覧できますか？	今日の観測データは、アメダス（表形式）または最新の気象データのページをご覧ください。
気象庁ホームページから気象観測データをダウンロードできますか？	過去の気象データ・ダウンロードのページをご利用ください。このページでは、必要とする期間、地点、要素、「日最高気温３０℃以上」など、「ある値以上」といった条件で検索した時、日、旬、月ごとの気象データを、CSV形式でダウンロードすることができます。
観測地点に関する情報（緯度・経度・海面上の高さ等）を知りたいのですが？	観測地点の詳しい情報については、地域気象観測所一覧[PDF形式]をご覧ください。
アメダスの詳しい住所を知りたいのですが？	アメダス観測所は無人で運用しています。地番の所在地情報については、過去にこの所在地情報を基にアメダス観測所を設置している機関に対して直接電話や訪問などが多々行われたため、迷惑がかかったことから、所在地情報の詳細については非公開としています。
アメダスの日照時間や積雪深が全く表示されない地点があるのですが、なぜですか？	アメダスでは日照時間や積雪深を観測していない地点があります。これらの地点では日照時間や積雪深のデータが表示されません。詳細は、地域気象観測システム（アメダス）をご覧ください。
アメダスの湿度と気圧の欄がないのは、なぜですか？	アメダスでは湿度と気圧を観測していません。最寄りの気象台や特別地域気象観測所等のデータをご覧ください。（参考）地上気象観測
過去の気象データ検索で、日降水量より日最大１時間降水量の方が大きいことがあるのはどうしてですか？	統計値に関する質問をご覧ください。
過去の気象データ検索で、降水量の表示に「0」と「-」がありますが、違いは何ですか？	統計値に関する質問をご覧ください。
過去の気象データ検索で、天気概況が表示されない地点がありますが、なぜですか？	統計値に関する質問をご覧ください。
過去の気象データ検索で、）や］や＃などの記号が入っていますが何ですか？	統計値を利用する上で注意が必要な数値であることを示します。値欄の記号の説明をご覧ください。
アメダス観測データやウィンドプロファイラの観測データを気象データセットとして入手したいのですが？	観測データの入手につきましては、（一財）気象業務支援センターがCD-ROMを販売していますので以下へお問合せください。　　一般財団法人気象業務支援センター　電話番号０３－５２８１－０４４０
平年値とは何ですか？	平年値は、その時々の気象（気温、降水量、日照時間等）や天候（冷夏、暖冬、少雨、多雨等）を評価する基準として利用されると共に、その地点の気候を表す値として用いられています。平年値は西暦年の１位が１の年から数えて、連続する３０年間について算出した累年平均値をいい、これをその統計期間に引き続く１０年間使用し１０年ごとに更新しています。現在は、1981～2010年（昭和５６年～平成２２年）の観測値に基づいた平年値を使用しています。
平年値の統計期間は３０年間なのはなぜですか。なぜ１０年ごとに更新されるのですか。	世界気象機関（WMO）の技術規則により、３０年間の観測値を用いて平年値を作成しています。欧米や日本など多くの国では、気候変動や観測地点の変化等を考慮して、１０年ごとに更新しています。
津波に関する特別警報は河川のある自治体に発表されるのですか？特別警報が発表される範囲はどのようになるのですか？	津波に関する特別警報の発表は、市町村単位ではなく海岸線に沿った「津波予報区」に対して行われます。そのため、河川に対しては発表されません。これは、従来の津波警報と同様です。
津波注意報であっても、潮位や天候の状況を考慮し発表することも必要であるのではないですか？	気象庁では、潮位を考慮して沿岸での津波を精度良く予測する技術を現在開発しているところです。将来的には要望いただいた潮位を加味した津波の予報が行えるよう、技術開発に努めて参ります。
津波の特別警報の基準を３ｍ超から５ｍ超に変更すべきではないですか？	過去に発生した津波被害について、津波の高さと被害の関係を見ると、概ね３ｍ程度から被害が発生しています。これを踏まえ、従来から３ｍ超を大津波警報と位置づけており、特別警報についても、同様に３ｍ超を基準としています。
発表のタイミングは、津波の発生が確認された時点とすべきではないですか？また、基準については、「沖合津波計の観測データにより」を頭に加えるなどしてはいかがですか？	気象庁では、津波からの迅速な避難行動を取っていただけるよう、地震の観測データをもとに、地震発生から約３分を目途に大津波警報、津波警報を発表することとしております。仮に津波の発生を沖合津波計等で観測するまで大津波警報、津波警報の発表を控えるとすると、その分、警報の発表から沿岸に津波が到達するまでの猶予時間が短くなり、避難行動の遅れにつながります。したがって、大津波警報、津波警報の発表のタイミングは現在運用されている通りとすることが適切と考えます。
大津波警報＝特別警報であるなら、特段、特別警報としての位置付けを行う必要性を感じません。津波については運用外でも良いのではないですか？	特別警報は重大な災害の起こるおそれが著しく大きい場合に発表します。そのため、都道府県から市町村への伝達を義務とするなどこれまでの警報以上の防災対応を自治体等に求めています。大津波警報は、まさにこの特別警報に該当する災害の発生が予想される際に発表されるものであり、防災対応の強化のためにも特別警報に位置づけているものです。
震度６弱以上を「特別警報」に位置づけることの意義は何ですか？予想震度にも誤差がある状況なので、観測体制が整い精度が向上してからでよいのではないですか？	緊急地震速報の予報精度に課題はありますが、特別警報と位置づけることで、重大な災害の起こるおそれが著しく大きいという危機感を伝えられるようにしたいと考えます。また、過去の地震発生時の調査から震度６弱以上になると建物の全壊率が高くなることがわかっており、震度６弱以上を特別警報の基準としています。
地震動が「予想される場合」とされているが、緊急地震速報が間に合わない直下型も考えられるので注釈が必要ではないですか？	ご指摘の通り、原理上、直下型の地震などでは緊急地震速報の発表が大きな揺れの開始に間に合わない場合があります。気象庁では、引き続き、これら緊急地震速報の特性や家具の固定など常日頃からの備えが重要であることの周知・啓発に努めていきます。
震度６弱以上は、「特別警報」に位置づけられていますが、発表時は従来の緊急地震速報（警報）と変わらない点など位置づけを明確にすべきではないですか？	ご指摘の混乱を与えないよう、気象庁としても、緊急地震速報における特別警報の位置づけや警報発表時にとっていただきたい行動などについて、平時からの周知・啓発に努めていきます。
地震はどうして起きるのですか？	地震とは、地下の岩盤が周囲から押されることによってある面を境としてずれる現象のことをいいます。この岩盤のずれが起きると地震波が周囲に伝わり、やがて地表に達すると地表が「揺れ」ます。私たちはこの「揺れ」で、地震が地下で発生したことを知ります。
震源域とは何ですか？	地震は地下の岩盤がずれて起こるものです。地震が発生したときの岩盤のずれ（断層）が生じた領域のことを震源域と言います。一般的に震源域はマグニチュード７の地震で数十km程度、マグニチュード８の地震で100～200km程度、マグニチュード９の地震で500～1000km程度です。なお、震源は岩盤のずれが始まったところを指すのに対し、震源域はそのずれが地震波を周囲に発しながら広がり、最終的にずれ破壊を生じた領域全体を指します。
断層とは何ですか？	地震は、地下の岩盤が周囲から押されることによってある面を境としてずれる現象のことをいいます。このずれを断層といいます。通常、地層は水平に堆積しています。地震による岩盤のずれによって、この層を断ち切るためにこのように呼ばれています。断層は面的な広がりがあり、断層面といいます。震源の深さが地表に近くなると断層が地表にまで現れることがあり、兵庫県の淡路島の野島断層や岐阜県本巣市の根尾谷断層が有名です。
活断層とは何ですか？	通常は地表に現れている断層と認められる地形のうち、最近の地質時代（第四紀以降：最近約170～200万年）に活動し、今後も活動しそうな（＝地震を発生させるような）ものを活断層といいます。
プレートとは何ですか？	世界中の地震の発生場所を見ると、細長く帯状に配列しています。この帯がプレートとプレートの境界に相当し、世界は10数枚の主なプレートで隙間なく覆われています。地球の半径約6,400kmに比べて、プレートは、厚さ10～100km程度の板のように見えるので、英語で板を意味するプレート（plate）と呼ばれています。それぞれのプレートは動いていて、その境界ではプレートどうしが衝突したり、一方のプレートの下にもう一方のプレートが潜り込んだり（沈み込んだり）しています。そのときにプレートにかかる力が原因となって地震が発生します。なお、プレートの中央部ではほとんど地震は発生していません。
余震とは何ですか？なぜ、一ヶ月以上もたって発生した地震が余震だと分かるのですか？	大きな地震（本震）が発生すると、直後から大きな地震が発生した場所付近で無数の小さな地震が発生します。これが余震です。余震は大きな地震の直後ほど発生数は多く、時間が経つにつれだんだんと減っていきますが、一ヶ月以上、あるいは数十年以上にわたって続くものもあります。余震は、本震の時の断層運動によって生じた破壊が徐々に静まる過程で発生していると考えられています。余震は本震の断層に沿って発生し、余震の発生している場所を余震域といいます。関連リンク余震について
地震の空白域とは何ですか？	地震の分布図を描くと、周辺には地震活動があるものの、その部分だけ地震が起こっていない（あるいは、比較的静穏な）ところが現れる場合があります。これを空白域と呼びます。空白域には大きく分けて２つの種類があります。海溝型の大地震の震源域を地図上に描くと、それぞれは重なり合うことなく、海溝に沿って並ぶ性質がありますが、これらの震源域の間に隙間が見られることがあります。このような場所は、最近長い間大きな地震が発生していないものの、大地震が発生する可能性を秘めている場所と考えられ、これを第１種空白域と呼びます。被害をもたらすような大地震はまれにしか発生しませんが、より小さな地震は、人体に感じないような微少な地震を含めて、日常的に多数発生しています。このような日常的に発生する地震の数がある地域で一時的に低下し、その後その地域で大地震が発生するという現象が見られる場合があります。このような日常的な地震発生数の低下現象を、地震活動の静穏化と呼び、その現象が現れた地域を第２種空白域と呼びます。このように、地震が発生していない地域を全て、地震の空白域と呼んでいるわけではありません。
直下型地震とはどのような地震ですか？	一般的に「直下型地震」は、都市部などの直下で発生する地震で、大きな被害をもたらすものを指すことが多いようですが、「直下型地震」に地震学上の明確な定義はありません。地殻内で発生する浅い地震の規模は、海溝付近で発生する巨大地震に比べて小さいことが多いのですが、地震が発生する場所が浅く真上の人が住む地域に近い場合があるため、マグニチュード６～７程度でも大きな被害をもたらすことがあります。
世界や日本周辺ではどのくらい地震が起こっているのですか？	１年間の平均でみた、世界で起こっている地震の数は表１のとおりです。表１　世界の地震回数（１年間の平均：USGS（アメリカ地質調査所）による）マグニチュード
××日の地震で○○市の震度情報が発表されないのはなぜですか？地震情報で発表された震度は、体で感じた揺れより小さいと思いますがどうなっていますか？地震の揺れを感じましたが、地震情報が発表されないのはなぜですか？	一般的に震度計は観測地点での揺れ（地震動）を計測していますが、地震動は地盤や地形に大きく影響されるため、同じ町、丁目内であっても場所によって震度が1階級程度異なる場合があります。基本的な地盤の状態が異なる場合（例えば固い岩盤とやわらかい沖積地）などは、地震が起きたところからの距離がほぼ同じ隣り合う市町村であっても、観測される震度に差が生じることがあります。また、地殻内のごく浅いところで地震が発生した場合、規模が小さくても人体に感じることがあります。その場合、揺れが感じられるのは狭い範囲に限られていることが多く、すぐ近くに震度計が無ければ、震度１以上（計測震度0.5以上）の揺れとして観測されないこともあり、この場合地震情報の発表はありません。気象庁では震度1以上を観測した観測点名を「各地の震度に関する情報」で発表しますので、この情報に含まれない場所では震度１以上を観測しなかったものと思われます。なお、地震が多数発生した場合には、震度３以上の地震についてのみ「震源・震度に関する情報」及び「各地の震度に関する情報」を発表し、震度２以下の地震については、「地震情報（地震回数に関する情報）」で地震回数をまとめて発表します。地震が発生し地震情報が発表された場合は、震源及び震度が精査され、翌日の夜に震度データベース検索に反映されますので、ご活用ください。さらに、気象庁では、震度１に満たないような地震についても、地震計により常時監視しており、地震計で観測した小さな地震のデータについても、発生した翌日の夜に毎日の地震活動で公開していますので、小さな地震の発生状況の確認が必要な場合は、それらのデータもご活用下さい。
テレビなどで○○市震度×と発表される画面をよく視聴しますが、震度の情報はこれだけなのでしょうか？	気象庁の震度に関する情報発表について説明します。震度３以上の地震が発生した場合、　地震発生約１分半後に「震度速報」　その後に「震源・震度に関する情報」と「各地の震度に関する情報」を発表します。「震度速報」は、震度３以上を観測した観測点を含む地域名称（全国を約１９０に区分したもの、新潟県上越、富山県東部等）を発表します。「震源・震度に関する情報」は、地震の発生場所（震源）やその規模（マグニチュード）、震度３以上の地域名と市町村名を発表し、また、震度５弱以上と考えられる地域で、震度を入手していない地点がある場合は、その市町村名を発表します。「各地の震度に関する情報」は、震度１以上を観測した地点のほか、地震の発生場所（震源）やその規模（マグニチュード）を発表します。これは、防災対応と観測データの収集状況を考慮し、まずは、地域名、次に市町村名、最後に、各観測点での震度へと、より詳細な情報を発表する仕組みとなっています。以上のとおり、初めのうちの情報は、地域名称、市町村名ですが、「各地の震度に関する情報」では、観測点ごとの震度があり、気象庁ホームページでもご覧になれます。また、全国いずれかの観測点で震度５弱以上を観測した地震では、推計震度分布図を発表し、気象庁のホームページにも掲載します。推計震度分布図とは、気象庁や地方公共団体等の震度計で観測された各地の震度データを元に１kmメッシュ毎の震度を推計したものです。関連リンク地震情報について地震情報報道発表資料　推計震度分布図の迅速な発表について（平成20年1月10日）
震度とマグニチュードはどう違うのですか？	震度は、ある場所での地震による揺れの強さをあらわし、マグニチュードは地震そのものの大きさをあらわします。これは電球の明るさと周りの明るさとの関係によく似ています。電球の明るさをあらわす値がマグニチュード、電球から離れたある場所の明るさが震度に相当します。つまりマグニチュードが大きくても（電球が明るくても）震源から遠いところでは震度は小さく（暗く）なります。
マグニチュードや震度は世界共通なのですか？	マグニチュードは大まかに言うと世界共通（定義としては一つ）です。ただし、使っている地震計や地震観測網が違うために、それぞれ異なるマグニチュードの値が計算され、その結果、新聞などで見る外国の地震のマグニチュードが同じ地震なのに少し違っている場合があります。震度は、その国の建物の壊れやすさなどにより異なり、したがって国によって異なっています。日本では、０、１、２、３、４、５弱、５強、６弱、６強、７の10階級で表し、震度計で観測します。一方、外国では主にMM震度階（モディファイド・メルカリ・スケール（改正メルカリ震度階））という12階級での表現を使っています。これは体感や被害によるものです。日本でも以前は体感による震度観測を行い、震度７の地域については事後の現地調査で決定していました。現在は、震度計により震度を観測し、速報する体制をとっています。
MM震度階（改正メルカリ震度階）と気象庁震度階級はどのように対応するのですか？	原理的には、同じ場所で震度計による観測とMM震度階による震度が得られていれば対応づけられますが、現在では、１対１に対応づけることは難しくなっています。それは、MM震度階は主に地震による被害に基づいているのに対し気象庁震度階級は震度計によっていること、外国と日本の建築様式が異なっていること等によります。また、日本のような人口密集地では、震度と地震動による被害はすぐに結びつけられますが、外国ではかなりの大地震でも、その場所に人が住んでいないことがあり、ＭＭ震度階のデータが得られないこともあります。
マグニチュード（M）とエネルギーの関係を教えてください。	マグニチュード(M)と地震波の形で放出されるエネルギーとの間には、標準的にはＭの値が１大きくなるとエネルギーは約３２倍に、Mの値が２大きくなるとエネルギーは１０００倍になるという関係があります。M８の地震の１つでＭ７の地震約３２個、M６の地震１０００個分のエネルギーに相当します。
モーメントマグニチュードとは何ですか？	地震は地下の岩盤がずれて起こるものです。この岩盤のずれの規模（ずれ動いた部分の面積×ずれた量×岩石の硬さ）をもとにして計算したマグニチュードを、モーメントマグニチュード（Mw）と言います。普通のマグニチュード（M）は地震計で観測される波の振幅から計算されますが、規模の大きな地震になると岩盤のずれの規模を正確に表せません。これに対してモーメントマグニチュードは物理的な意味が明確で、大きな地震に対しても有効です。ただし、その値を求めるには高性能の地震計のデータを使った複雑な計算が必要なため、地震発生直後迅速に計算することや、規模の小さい地震で精度よく計算するのは困難です。関連リンクＣＭＴ解とは何か
兵庫県南部地震のマグニチュード（M）で、M7.3と書いてある資料と、M7.2とある資料がありますが、どちらが正しいのですか。	2003年に気象庁ではマグニチュードの改訂を行い、計算式を改良しました。兵庫県南部地震のMは当初M7.2でしたが、この計算式に従って再計算を行い、M7.3に改訂しました。（兵庫県南部地震など、1994～2001年の間に発生した顕著な地震は先行して2001年４月に改訂し、その他は2003年９月に改訂を行っています。）古い資料や古い資料をそのまま引用している資料には、M7.2のままのものがあると考えられます。関連リンク報道発表資料　気象庁マグニチュード検討委員会の検討結果（平成13年4月23日）［PDF形式 48KB］報道発表資料　気象庁マグニチュード算出方法の改訂について（平成15年9月17日）［PDF形式 228KB］
震度７は、加速度で何ガルに対応するのですか？	私たちが地震による揺れ（地震動）を強く感じるか否かは、地面の揺れの波（地震波）の周期（１回の波の振動にかかる時間）と揺れの幅（振幅）の大きさによって大きく変わります。地震波は色々な周期の波を含んでいるので、一概にいくつとは言えません。震度７の下限である計測震度6.5以上となるために単一周期の波が何波か続くと仮定すれば、周期0.1秒で約2700ガル以上、周期0.5秒で約900ガル以上になります。これまでに震度７を観測したのは、気象庁が1949年に震度７の震度階級を設定してから３回あります。１回目は現地調査で判明した「平成７年（1995年）兵庫県南部地震」です。２回目は、計測震度計で震度７を観測した「平成16年（2004年）新潟県中越地震」です。３回目は、計測震度計で震度７を観測した平成23年（2011年）東北地方太平洋沖地震です。新潟県中越地震で震度７を観測した川口町川口（現：長岡市）の最大合成加速度値は1722ガル（最大加速度周期は約１秒）でした。関連リンク震度と加速度
震央付近では小さい震度であるにもかかわらず、震央から離れた太平洋側で大きな震度を観測する地震について教えてください。	震源が非常に深い場合、震源の真上ではほとんど揺れないのに、震源から遠くはなれた太平洋側の場所で揺れを感じることがあります。この現象は、「異常震域」という名称で知られています。原因は、地球内部の岩盤の性質の違いによるものです。大陸プレートの地下深くまで太平洋プレートなどの海洋プレートが潜り込んで（沈み込んで）います。通常、地震波は震源から遠くになるほど減衰するものですが、この海洋プレートは地震波をあまり減衰せずに伝えやすい性質を持っています。このため、沈み込んだ海洋プレートのかなり深い場所で地震が発生すると（深発地震）、真上には地震波があまり伝わらないにもかかわらず、海洋プレートでは地震波はあまり減衰せずに伝わり太平洋側に揺れを伝えます。その結果、震源直上の地表での揺れ（震度）が小さくとも、太平洋側で震度が大きくなります。例えば異常震域となった地震に、平成19年7月16日の京都府沖の地震（深さ374km)があります。京都府沖の地震については、地震調査研究推進本部地震調査委員会へ気象庁が報告した資料がホームページで公開されていますので、ご覧下さい。平成19年7月16日　京都府沖の深発地震
地震による強い揺れはどの位長く続くのですか？	地震による強い揺れが続く時間は、その地震の断層運動（岩盤がずれる動き）が継続する時間とほぼ同じです。日本付近で発生する地震による強い揺れは、マグニチュード７クラスの地震であれば約10秒間、マグニチュード８クラスの地震であれば約１分間、マグニチュード９クラスの地震であれば約３分間継続します。例えば、「平成７年（1995年）兵庫県南部地震」では15秒程度、「平成23年（2011年）東北地方太平洋沖地震」では長く続いたところで190秒程度でした。
報道発表資料で震源の位置やマグニチュードの値などに「速報値」もしくは「暫定値」という表現が用いられていますが、この違いは何ですか？	「速報値」とは、地震情報や津波警報・注意報など地震発生直後に発表される情報に用いられる値のことです。地震発生時には、国民の皆様に速やかに情報をお伝えする必要があるため、「速報値」の計算には限られた地震観測点のデータを使用しています。「暫定値」とは、「速報値」よりも数多くの地震観測点のデータを使用して計算された値のことです。データの数が増えるため、「速報値」よりも震源の位置やマグニチュードの精度は上がりますが、処理に時間がかかり、通常は地震が発生した日の翌日に更新されます。ただし、規模の大きな地震が発生した場合は、地震情報などで「速報値」を発表した後、速やかに「暫定値」の計算を行い、報道発表資料などで「暫定値」を発表することとしています。後日、「暫定値」についてさらに精査を行い、値を最終確定します。その結果は「気象庁地震・火山月報（カタログ編）」に収録されます。
気象庁ホームページへの地震情報の掲載が遅いと感じますが早くならないでしょうか。	地震情報は国民の生命、財産を守るための重要な防災情報として位置づけられており、地震発生後１秒でも速く防災関係機関（政府などの国の機関、一般の方へ周知するために報道機関）に伝達しています。これらの機関への情報伝達は、専用の通信回線により安定的、瞬間的に伝達しています。一方、インターネットホームページによる提供は、見たいときに見たいものが見られるという利点がありますが、回線が安定的に運営される保証がない、欲しい情報を自己責任で取りに行く必要がある、更新が自動で行われない、というインターネットの特徴に留意のうえ利用していただく必要があります。
地震の予知はできますか？	地震を予知するということは、地震の起こる時、場所、大きさの三つの要素を精度よく限定して予測することです。例えば「（時）一年以内に、（場所）日本の内陸部で、（大きさ）マグニチュード５の地震が起こる」というようなあいまいな予測や、毎日起きているマグニチュード４程度以下の小さな地震を予測するような場合はたいてい当たりますが、それは情報としての価値はあまりないと考えます。少なくとも「（時）一週間以内に、（場所）東京直下で、（大きさ）マグニチュード６～７の地震が発生する」というように限定されている必要があります。時を限定するためには、地震の予測される地域で科学的な観測が十分に行われ、常時監視体制が整っていることが欠かせません。そのような体制が整っていて予知のできる可能性があるのは、現在のところ（場所）駿河湾付近からその沖合いを震源とする、（大きさ）マグニチュード８クラスのいわゆる「東海地震」だけです。それ以外の地震については直前に予知できるほど現在の科学技術が進んでいません。
東海地域にはどのような監視体制がとられていますか？	東海地震の前兆現象を捉えるため、東海地域及びその周辺に各種の観測機器が設置されています。これらの機器には気象庁が整備した地震計、地殻岩石歪計のほか、国土地理院、海上保安庁、国立研究開発法人防災科学技術研究所、国立研究開発法人産業技術総合研究所、東京大学、名古屋大学及び静岡県の各機関が設置したものがあり（地震、地殻変動、地下水等）、気象庁にデータが集められ、常時監視しています。
東海地震は必ず予知できるのですか？	必ず予知できるのかとの問いには、「いいえ」となります。東海地域の観測網により前兆現象をとらえることができた場合のみ、気象庁は東海地震に関連する情報を発表してみなさんにお知らせすることができます。どのくらいの確率で前兆現象をとらえることができるのかは、残念ながら「不明」です。東海地震予知の鍵となる前兆現象は、前兆すべりと考えられています。前兆すべりとは、震源域（東海地震の場合、プレート境界の強く固着している領域）の一部が地震の発生前に剥がれ、ゆっくりと滑り動き始めるとされる現象です。気象庁は、東海地域に設置した歪計（ひずみけい）で前兆すべりをとらえようとしています。逆に、このような前兆すべりがとらえられない場合（前兆すべりの規模が小さすぎた、前兆すべりが沖合で発生した等、観測網でとらえられなかった場合。前兆すべりが生じるとする考え方が誤りであった場合。）や前兆すべりの進行があまりにも急激で時間的に余裕がない場合には、残念ながら情報発表がないまま地震発生に至ることになります。関連リンク東海地震に関する解説資料のページ
東海地震に関連する情報はどのような時に発表され、そのとき私たち（住民）はどう行動すればよいのですか？	東海地震に関連する情報は三種類あり、危険度が低い方から高い方へ、東海地震に関連する調査情報（臨時）、東海地震注意情報、東海地震予知情報、となります。東海地震に関連する調査情報（臨時）観測された現象が東海地震の前兆現象であると直ちに判断できない場合や、前兆現象とは関係がないことがわかった場合に発表されます。住民の方は、平常どおりお過ごし下さい。 東海地震注意情報観測された現象が前兆現象である可能性が高まった場合に発表されます。ほぼ同時に、政府から防災に関する呼び掛けが行われます。これに合わせ、防災関係機関の中には、一部準備行動を開始するところもあります。学校や企業の中には、児童や職員の帰宅を行うところもありますので、住民の方は政府からの呼び掛けや、予め自治体等が定める防災計画に従って行動して下さい。 東海地震予知情報東海地震の発生のおそれがあると判断された場合に発表されます。ほぼ同時に内閣総理大臣から警戒宣言が発表され、本格的な防災体制が敷かれます。住民の方は、東海地震の発生に十分警戒し、予め自治体等が定める防災計画に従って行動して下さい。関連リンク東海地震に関する解説資料のページ
東海地震に関連する情報の発表基準にある「歪計」（ひずみけい）とはどのようなものですか？	地下の岩盤の伸び・縮みを非常に高感度で観測できる地殻変動の観測装置のことです。ボアホールと呼ばれる直径15cm位の縦穴を数百ｍ掘削し、その底に埋設します。前兆すべりの発生に伴う微弱な岩盤の変化を捉えるための鍵となる観測装置と考えています。関連リンク地殻岩石歪計のイラスト東海地震に関する解説資料のページ
東海地震による震度や津波はどの程度になると考えられていますか？	「東海地震の発生で予測される震度や津波の高さ」をご覧ください。
動物や植物は地震を予知できるのですか？	動植物には、音、電気、電磁波、匂いなどに対する感知力が人間などに比べ格段に優れているものがあることは知られています。一方、地震は、地中の広い範囲で、固い岩盤同士が、破壊し合い、ずれ合う大きなエネルギーの集中や解放を伴うため、徐々に岩盤が変形し始めたり、地下水位が変動したりして、地震の発生前から非常に微弱で特異な音、電気、電磁波、匂いなどが周辺の地面や大気などに現れるようなことがあれば、それを動植物には感じ取ることができる場合があるのかもしれません。しかし、動植物は地震以外の理由によって通常と異なる行動・反応をすることがあり、また、動植物自体についてまだわかっていないことも多く、ましてや地震の前兆現象も解明できていない部分が多いことから、地震の前にそうした異常行動・反応をする理由について科学的に説明できていない状況です。従って、次項の「地震雲」と同様に、動植物の行動・反応を観察することで実用的な地震予知を行うのは極めて困難と言えます。
地震雲はあるのですか？	雲は大気の現象であり、地震は大地の現象で、両者は全く別の現象です。雲のたなびく向きは、上空の気流によって支配されています。気流が地形の影響を受けることはありますが、地震の影響を受ける科学的なメカニズムは説明できていません。「地震雲」が無いと言いきるのは難しいですが、仮に「地震雲」があるとしても、「地震雲」とはどのような雲で、地震とどのような関係であらわれるのかが科学的な説明がなされていない状態です。日本における震度１以上を観測した地震（以下、有感地震）数は、概ね年間2,000個程度あり、平均すれば日本のいずれかの場所で一日あたり５個程度の有感地震が発生していることとなります。震度４以上を観測した地震についても、平成16年で105個、平成17年で49個、平成18年で28個、平成19年で57個発生しています。このように地震はいつもどこかで発生している現象です。雲は上空の気流や太陽光などにより珍しい形や色に見える場合がありますし、夜間は正確な形状を確認することができません。形の変わった雲と地震の発生は、ある程度の頻度で発生する全く関連のないふたつの現象が偶然見かけ上、そのように結びつけられることがあるという状況であり、現時点では、科学的な扱いは出来ていません。
○月×日に□□地方で大きな地震があると聞きましたが、どうでしょうか？	現在の科学技術では、時期・場所・地震の規模を特定した地震予知ができる可能性があるのは、唯一東海地震のみです。これは東海地震が100～150年という比較的短い間隔で歴史的に繰り返されてきたこと、発生の原因がかなり解明されていること、発生場所が陸域の地下を広く含むため観測体制が整えやすいこと等の条件が重なっているためです。他の地震については、残念ながら現在のところ予知をすることはできません。以上により、東海地震以外で日時と場所を特定した地震を予知する情報はデマと考えられます。なお、東海地震については、その発生が予想されるような現象を観測した場合、気象庁から情報を発表します。お聞きになった情報で心配される必要はありませんが、日本は地震国であり、地震が起こらない場所はないと言っても過言ではありません。日ごろから地震に対する備えをお願いいたします。
なぜ、館内放送等では具体的な予測震度や猶予時間を伝えない方が良いの？	個々の施設に対して、緊急地震速報に含まれる震源やマグニチュードなどから、その場所における「震度」や「猶予時間」を予測し、報じることは技術的には可能です。しかし、この予測には誤差が含まれます。特に、地震発生直後の早いタイミングの緊急地震速報での予測では誤差は大きくなる傾向があります。このことから、地震動予報許可事業者には、個々の予測を利用していただく方々との間で緊急地震速報の受信や販売契約等を交わす際に、利用者へ緊急地震速報の技術的な限界や誤差のことを十分説明するよう指導しています。このような限界や誤差があることを一般の方々が多数いる集客施設等で事前に説明することは難しいと思われますので、具体的な予測震度や猶予時間を伝えない方が良いと考えています。　なお、上記については、集客施設等の管理者がその施設での対応状況（施設利用者への周知や従業員等の訓練の状況等）をもとに独自の判断による発表基準や表現等の導入を妨げるものではありません。
津波はどのような仕組みで発生するのですか？	地震が起きると、震源付近では地面が持ち上がったり、下がったりします。震源が海底下で浅い場合、海底が持ち上がったり下がったりすることになります。その結果、周辺の広い範囲にある海水全体が短時間に急激に持ち上がったり下がったりし、それにより発生した海面のもり上がりまたは沈みこみによる波が周りに広がっていきます。これが津波です。
津波の前には必ず潮が引くと聞きましたが、本当ですか？	それは、間違いです。地震の発生の仕方によっては、いきなり大きな波が押し寄せることもあります。平成15年(2003年)十勝沖地震による津波や、2004年のスマトラ沖地震の際にスリランカやインドの沿岸に押し寄せた津波では、直前に潮が引くことなく大きな波が押し寄せました。
30cmの津波でも危険なのはなぜですか？	地震が起きると、震源付近では地面が持ち上がったり、下がったりします。震源が海底で地下浅い場合、海底が持ち上がったり下がったりすることになります。その結果、海面も持ち上がったり下がったりし、それが波となって周りに広がっていきます。これが津波です。従って津波は、通常の海の波のように表面だけがうねっている波と大きく異なり、海底から海面まで全てが移動する大変スピードのある、エネルギーの大きな波です。津波の高さが高くなってくると、それにつれて、海水の横方向（津波の進行方向）の動きも大きくなってきます。海水の横方向の動きが大きくなってくると、水深の浅いところでも立っていることが困難になってきます。海水中に立っているとき20～30センチ程度でも水かさがあがれば体が浮き上がり同時に横方向に押されればどうなるか想像できると思います。横方向の海水の動き（流速）についての海水浴場の安全基準としては、0.2～0.3m／秒程度以下が適当と言われており、0.3～0.35m／秒程度で遊泳注意・部分禁止となることが多いようです。津波の高さが0.2mを超えると、流速が0.3m／秒を超える例が多くなることが幾つかの調査で知られています。このこともあって、津波の高さが0.2mを超えると予測される海岸には、津波注意報を発表することにしています。津波注意報が発表されたら海から上がって速やかに堤防より陸側に移動してください。津波の高さが１ｍを超えると木造家屋等に被害が出始めます。津波の高さが１ｍ程度を超えると予測される海岸には津波警報が、さらに３ｍ程度を超えると予測される海岸には大津波警報が発表されます。このときには、大至急、安全な高台などに避難してください。また、沿岸近くで発生した津波には津波警報・注意報の発表が間に合わないこともあります。海岸付近で、強い揺れを感じたら念のため津波の発生に用心してください。
波浪と津波の違いは何ですか？	海域で吹いている風によって生じる波浪は海面付近の現象で、波長（波の山から山、または谷から谷の長さ）は数メートル～数百メートル程度です。一方津波は、地震などにより海底地形が変形することで周辺の広い範囲にある海水全体が短時間に持ち上がったり下がったりし、それにより発生した海面のもり上がりまたは沈みこみによる波が周囲に広がって行く現象です。津波の波長は数キロから数百キロメートルと非常に長く、これは海底から海面までのすべての海水が巨大な水の塊となって沿岸に押し寄せることを意味します。このため津波は勢いが衰えずに連続して押し寄せ、沿岸での津波の高さ以上の標高まで駆け上がります。しかも、浅い海岸付近に来ると波の高さが急激に高くなる特徴があります。また、津波が引く場合も強い力で長時間にわたり引き続けるため、破壊した家屋などの漂流物を一気に海中に引き込みます。
津波の高さによってどのような被害が発生するのですか？	家屋被害については、建築方法等によって異なりますが、木造家屋では浸水１ｍ程度から部分破壊を起こし始め、２ｍで全面破壊に至りますが、浸水が50cm程度であっても船舶や木材などの漂流物の直撃によって被害が出る場合があります。下表の津波波高（ｍ）は、船舶・養殖筏など海上にあるものに対しては概ね海岸線における津波の高さ、家屋や防潮林など陸上にあるものに関しては、地面から測った浸水深となっています。※津波波高(m)は、船舶、養殖筏など海上にあるものに対しては概ね海岸線における津波の高さ、家屋や防潮林など陸上にあるものに関しては地面から測った浸水深となっています。※上表は津波の高さと被害の関係の一応の目安を示したもので、それぞれの沿岸の状況によっては、同じ津波の高さでも被害の状況が大きく異なることがあります。※津波による音の発生については、周期5分～10分程度の近地津波に対してのみ適用可能です。
津波の高さ○mと予報される場合、どこの地点で言うのですか？例えば、海岸線ですか。内陸部100m地点等のことですか。	津波情報の中で発表している「予想される津波の高さ」は、海岸線での値であり、津波予報区における平均的な値です。場所によっては予想された高さよりも高い津波が押し寄せることがあり、その旨を津波情報に記載することでお伝えしています。また、現在の津波予測技術では、「予想される津波の高さ」の予想精度は、1／2～２倍程度です。なお、「津波の高さ」とは、津波がない場合の潮位（平常潮位）から、津波によって海面が上昇したその高さの差を言います。さらに、海岸から内陸へ津波がかけ上がる高さを「遡上高（そじょうこう）」と呼んでいますが、「遡上高」は気象庁から発表される「予想される津波の高さ」と同程度から、高い場合には４倍程度までになることが知られています。どの地域が津波により浸水するおそれがあるかについては、自治体では津波ハザードマップ（津波浸水予測図）を作成しているところもありますので、自治体にお問い合わせ下さい。津波注意報が発表された際には海岸や河口から離れ、津波警報が発表された際には、自治体が指定した避難場所や高台に、可能な限り早く避難することをお願いいたします。また、津波警報・津波注意報が発表されていなくても、沿岸付近で強い揺れを感じた時や弱い揺れでも長い時間ゆっくりとした揺れを感じた時はすぐに避難してください。
津波予報の文中にある「海面変動」とは津波のことですか？	津波予報で発表される海面変動とは、津波警報・津波注意報を発表する基準には達しないものの、若干の津波が観測される可能性がある場合に用います。「津波」という言葉が災害を連想するため、若干の津波については被害を及ぼさない津波という安心情報を伝えるために、あえて「海面変動」という言葉を用いています。
日本で一番大きな津波は何ですか？	2011年3月11日に発生した「平成23年（2011年）東北地方太平洋沖地震」による津波では、『東北地方太平洋沖地震津波合同調査グループ』による調査により、岩手県大船渡市の綾里湾で局所的に40.1mの遡上高（海岸から内陸へ津波がかけ上がった高さ）が観測されました。※　記録に残っている中では、1896年の明治三陸津波（遡上高で約38.2ｍと推定：同じく岩手県大船渡市）を上回り、これまでに日本で記録された最大の津波となりました。　ただし、これらはここ100年間程度の、記録が残されている範囲での値であり、それ以前にも同程度、あるいはより高い津波が日本の沿岸を襲った可能性があります。近年、過去の津波の痕跡から浸水範囲を推定する調査が進んでおり、今後、より大きな津波の証拠が見つかるかも知れません。　※東北地方太平洋沖地震津波合同調査グループ（http://www.coastal.jp/ttjt/）調査結果より
津波警報は、どのように伝えられるのですか？	津波警報は、地域住民に対して、テレビ・ラジオなどのマスメディア、携帯電話の緊急速報メール、市町村の防災行政無線や鐘音・サイレン※など様々な方法を用いて伝えられます。　※火災の発生等の周知に同じ鳴らし方の鐘音・サイレンを使用している市町村もあります。なお、すべての市町村で鐘音・サイレンが使われているわけではありません。
津波警報発表時の緊急警報放送とはどのようなものですか？	気象庁から津波警報が発表された時に、テレビ／ラジオなどの受信機から警報音を発し、お知らせするものです。　テレビ／ラジオのスイッチが入っていない状態でも、緊急警報放送に対応した受信機を使用し待機状態としておけば、緊急警報放送受信時に自動的に起動し、津波警報の発表を知ることができます。　緊急警報放送の詳しい説明については、日本放送協会（ＮＨＫ）のウェブサイトをご参照ください。
噴火警報・火口周辺警報・噴火予報について教えてください。	噴火に関する特別警報・警報及び予報は、全国の活火山を対象に発表し、内容には警戒事項や警戒等が必要となる市区町村を明示しています。わかりやすさと速報性の観点から、火口周辺や居住地域等の対象範囲を表す語を付して、それぞれ噴火警報（居住地域）（または噴火警報）、噴火警報（火口周辺）（または火口周辺警報）として用います。また、警戒事項等のキーワードを設定し、噴火警戒レベル設定火山はレベルとキーワードを、未設定の火山についても火口周辺危険、入山危険等のキーワードを付して発表します。特別警報・警報を解除する場合等には「噴火予報」を発表します。　噴火警報、火口周辺警報及び噴火予報の発表開始により、従来の緊急火山情報、臨時火山情報、火山観測情報は廃止しました。　噴火警報（居住地域）（または噴火警報）は特別警報に位置づけられています。詳しくは、噴火警報、噴火予報の説明で解説しています。
噴火警戒レベルについて教えてください。	噴火警戒レベルとは、火山活動の状況を噴火時等の危険範囲や避難等の必要な防災対応に応じて５段階（レベル５～レベル１）に区分したものです。　住民や登山者・入山者等に必要な防災対応が分かりやすいように、各区分にそれぞれ「避難」「避難準備」「入山規制」「火口周辺規制」「活火山であることに留意」のキーワードをつけて警戒を呼びかけます。噴火警戒レベルは噴火に関する予報警報等で発表されます。　噴火警戒レベルの導入に伴い、火山活動度レベルは廃止しました。詳しくは、噴火警戒レベルの説明で解説しています。
活火山とは？	以前は過去およそ2000年以内に噴火した火山及び現在活発な噴気活動のある火山を活火山としてきました。　しかし、長期にわたって活動を休止した後に活動を再開した事例もあり、近年の火山学の発展に伴い過去1万年間の噴火履歴で活火山を定義するのが適当であるとの認識が国際的にも一般的になりつつあることから、2003（平成15）年1月に火山噴火予知連絡会は｢概ね過去1万年以内に噴火した火山及び現在活発な噴気活動のある火山｣を活火山と定義し直しました。　当初、活火山の数は108でしたが、2011（平成23）年にはさらに2火山が選定され、現在の活火山の数は全国で110となっています。 詳しくは、活火山とはで解説しています。
「休火山」や「死火山」という用語は、今もあるのですか？	以前は、現在噴火または噴気活動を続けている火山を活火山、現在は活動していないが歴史時代に活動した記録が残っている火山を休火山、歴史時代の活動の記録がない火山を死火山と分類していました。　しかし、年代測定法の進歩により火山の過去の活動が明らかになり、数万年に一度噴火する火山もあることが分かってきました。歴史時代だけで今後の噴火発生の有無を判断することは難しいので、近年は休火山や死火山という分類はなされていません。
「火山噴火予知連絡会」とは何ですか？	火山噴火予知連絡会は、文部省の測地学審議会（当時、現在の文部科学省科学技術・学術審議会測地学分科会）が昭和48年に建議した「火山噴火予知計画」を受けて、関係機関の研究及び業務に関する成果及び情報の交換、火山現象についての総合的判断等を行うため、昭和49年に設置されました。委員は学識経験者と関係機関の専門家から構成されており、気象庁が事務局を担当しています。気象庁では、火山噴火予知連絡会が行った火山活動に関する総合的な評価等を防災に役立てるため、その結果をとりまとめて発表しています。関連リンク火山噴火予知連絡会
エルニーニョ現象（ラニーニャ現象）が発生すると、日本近海の海面水温はどのようになるのですか？	エルニーニョ現象（ラニーニャ現象）が発生すると、大気循環が変化して、日本付近では冷夏・暖冬（猛暑・厳冬）になると云われています。そのような日本付近の気温の状態が日本付近の海面水温に影響を及ぼすことがあります。一方で、エルニーニョ現象（ラニーニャ現象）に伴う中・東部太平洋赤道域の水温変化が海洋を伝って、すぐに日本近海の海面水温を変化させることはありません。そのような水温変化が日本付近に到達するには数年かかると考えられ、またその間に大気の影響を受けるため、日本付近に到達する段階では水温の変化は不明瞭になります。
日本近海の海面水温が高い（低い）と、日本の地上気温は高く（低く）なるのですか？	大気と海洋は熱を交換しながら影響を及ぼしあって変動していますが、必ずしも海面水温が高いから地上気温が高くなるというわけではありません。たとえば、冬季の大陸からの寒気の吹き出しにより、海面水温が低下することがあります。この時、大気は海洋によって逆に暖められています。一方、夏季に太平洋高気圧に覆われるなどして晴天が続くと、気温と海面水温は高くなりますが、この時、海洋が大気を暖めているわけではありません。
海面水温が高いと台風が発生するのですか？	一般的に台風は海面水温が２６～２７℃の海域で発生するといわれています。ただし、大気の状態も重要な要因であり、海面水温が高いだけでは台風の発生・発達につながりません。
高潮の発生の仕組みは？	高潮は、台風や低気圧によって海面が上昇することです。高潮発生の主な要因としては、以下の2つを挙げることができます。気圧低下による海面の「吸い上げ効果」台風や低気圧の中心では気圧が周辺より低いため、気圧の高い周辺の空気は海水を押し下げ、中心付近の空気が海水を吸い上げるように作用する結果、海面が上昇します。気圧が1ヘクトパスカル（hPa）低くなると、海面は約1センチメートル上昇します。風による「吹き寄せ効果」台風に伴う強い風が沖から海岸に向かって吹くと、海水は海岸に吹き寄せられ、海岸付近の海面が上昇します。湾の形によっては、吹き寄せられた海水の逃げ場がないため、さらに海面が上昇しやすくなります。また、水深が浅いほど、風の吹き寄せ作用がよく働き、海面が上昇しやすくなります。
異常潮位とは何ですか？	「異常潮位」とは、台風などによって引き起こされる「高潮」や地震に伴う「津波」とは異なった原因で、潮位（海面の水位）がある程度の期間（概ね1週間から3か月程度）継続して平常時※より高く（もしくは低く）なる現象のことです。暖かい海水の渦（暖水渦、中心付近は周辺よりも海面の水位が高い）が接近した場合や、太平洋側では黒潮が通常より四国、本州などに接近した場合のほか、気圧配置などその他の要因と複合して発生すると考えられています。なお、例年、夏から秋にかけては、他の季節と比べて全国的に潮位は高くなりますので、この期間に異常潮位や高潮が生じて潮位がさらに高くなると、浸水などの被害を生じることがあります。最近では、平成１３年（2001年）に南西諸島及び関東地方から九州地方の沿岸で、平成１５年（2003年）に南西諸島及び東海地方から九州地方の沿岸で、いずれも夏から秋にかけて発生しています。※平常の潮位とは、台風などの影響がない場合の、月と太陽の引力などをもとにあらかじめ計算された潮位の値です。
副振動とは何ですか？	日々くり返す満潮・干潮の潮位変化を主振動としてそれ以外の潮位の振動に対して名づけられたもので、湾・海峡や港湾など陸や堤防に囲まれた海域等で観測される、周期数分から数１０分程度の海面の昇降現象をいいます。主な原因は、台風、低気圧等の気象じょう乱に起因する海洋のじょう乱や津波などにより発生した海面の変動が海洋長波（水深に比べ波長の長い波）となって沿岸域に伝わり、湾内等に入ることにより引き起こされる振動です。振動の周期が湾等の固有周期に近い場合は、共鳴を起こして潮位の変化が著しく大きくなることがあります。このような振動をセイシュとも言います。副振動は、全国どこの沿岸でも発生しますが、全振幅（海面昇降の山から谷までの高さ）が１００センチを超えるような顕著な副振動は、九州地方から奄美地方でしばしば観測され、海面昇降に伴う強い流れによる小型船舶の転覆や低地の浸水などの被害を生じることがあります。過去に、副振動による被害が多くみられる長崎では副振動のことを「あびき」と呼んでいます。　平成２１年（2009年）２月２４～２５日に九州地方から奄美地方にかけて顕著な副振動が発生し、熊本県と鹿児島県の沿岸で小型船舶の転覆や破損、家屋への浸水等の被害が発生しました。このとき観測された最大全振幅は長崎で１５７センチ、枕崎で１４１センチでした。
干潮、満潮の時刻はどのように予想するのですか？	潮汐（干潮、満潮）は、主に月と太陽による引力と地球の回転による遠心力をあわせた力（起潮力とよびます）で生じます。起潮力の周期は天文学の知識からわかります。ある地点の潮汐の予報を行うには、周期の他に潮汐の波の大きさや時間的な遅れの情報が必要となります。これらの値は地形や水深が異なるために場所ごとに違ってきますので、それぞれの地点で観測を行った結果から決定します。これらの値をもとに６０項位の三角関数を計算し、加えあわせることで潮汐（干潮、満潮）の予報を行っています。
アルゴ（ＡＲＧＯ）計画とはどんな計画ですか？	国際的な枠組みの中で「中層フロート」を全世界の海洋に展開し、表層から中層の水温、塩分等の観測をする計画。気候に大きく影響する海洋の状況を把握します。
地球温暖化についてまとめているページはありますか？	地球温暖化をご覧ください。
雨が降る前と降った後では、大気中のニ酸化炭素濃度には、違いはあるのですか？	雨が降る前と降った後で大気中のニ酸化炭素濃度には違いはありません。二酸化炭素は地球上に広く分布しているため、雲ができる段階ですでに雲粒に溶け込んでいると考えられます。実際の観測でも雨の降る前後で大気中の二酸化炭素濃度の変化は観測されていません。
気象庁で観測されている二酸化炭素の濃度は地上からどの程度の高さの濃度ですか？	気象庁では、二酸化炭素濃度が地表近くでの植物活動や人間活動から受ける影響を小さくするように、地上から約20メートルの高さから取り込まれた空気の二酸化炭素濃度を測定しています。
温暖化の影響で、動物や植物の生息域は広がっていますか？	動物や植物の生息域については、気象庁の専門外となります。生物を扱う科学館等にお問合せください。
外国の気候に関するデータが欲しいのですが？	世界の主な地点の月ごとの値及び平年値（月平均気温･月降水量）は、「世界の月天候データ」をご覧ください。
「異常気象」の定義はあるのですか？	一般には、過去に経験した現象から大きく外れた現象のことを言います。大雨や暴風等の激しい数時間の気象から、数か月も続く干ばつ、極端な冷夏・暖冬まで含みます。また、気象災害も異常気象に含む場合があります。気象庁では、気温や降水量などの異常を判断する場合、原則として「ある場所（地域）・ある時期（週、月、季節）において３０年に１回以下で発生する現象」を異常気象としています。
世界各地で熱波などの異常気象が発生していますが、地球温暖化と関係があるのですか？	個々の異常気象を分析してみると、多くの場合、上空の偏西風が通常とことなる位置を流れる状態が続いたことや、熱帯地域の対流活動の影響が遠い場所に伝わったことなど、地球の大気と海洋の自律的な変動による自然のゆらぎが一方的に大きく振れたときに、平年と比べ著しい高温となることがわかります。このような自然のゆらぎは、地球の気候システムに元々備わった性質であり、地球温暖化が原因で発生したと言うことはできません。　一方、大気中の温室効果ガス濃度の増加に伴って、世界のほとんどの地域で長期的に気温が上昇しています。言い換えると、「平年」の気温が昔に比べ高くなっています。上述の自然のゆらぎによる平年の気温からのずれの程度が同じであったとしても、平年の気温そのものが高くなっているために、過去にはほとんど経験されなかったような著しい高温が発生する確率が高まっていると考えられます。これはあくまで確率ですので、ある日の気温がたまたま高かったからといって、地球温暖化と関係があると断定することはできません。しかし、過去数十年にわたる観測データを分析すると、日本を含む世界各地で、顕著な高温の発生頻度が増えていることが分かっており、このような長期的な増加傾向は、地球温暖化の表れであると考えられます。
気象庁が発表する黄砂に関する情報にはどのようなものがありますか？	気象庁ホームページでは、「黄砂情報（黄砂観測実況図、黄砂予測図）」を毎日公表しています。また、視程の悪化による交通への影響や日常生活に広い範囲で影響を及ぼす黄砂が観測されたり、黄砂予測モデルや天気図等の解析から向こう２４時間先までに影響を及ぼすような黄砂が予想された場合には、各地の気象台は、担当予報区内における影響を踏まえて「黄砂に関する地方／府県気象情報」を発表します。黄砂の影響が全国的に広い範囲に及ぶ恐れがある場合には、気象庁予報部が「黄砂に関する全般気象情報」を発表します。黄砂に関する気象情報を発表する場合や、黄砂の動向に特に注意が必要と判断される場合には、「天気予報」の天気概況にも黄砂の状況やこの先の見通しに関する記述を行います。
黄砂の初日（終日）の平年値はいつですか？	黄砂は一般的に春に多く観測されますが、どの季節にも観測されるため初終日の統計は実施していません。
黄砂が日本に来るのは春だけでしょうか？	黄砂発生源が乾燥していて上空の風が日本へ向いて吹いているなどの条件が揃えば、春でなくても黄砂が飛来する可能性があります。春に黄砂がよく飛来するのは、黄砂発生源の地面状態の違いが大きく影響していると考えられています。夏から秋は植物が地面を覆っており、冬は土壌の凍結や積雪により、黄砂の発生が抑えられます。これに対し、春先は植物が充分に育っておらず、土壌の凍結や積雪もないため、黄砂の発生する可能性が高くなります。
空がかすみ、ベランダに塵が付着していますが黄砂情報が出ていません。黄砂ではないのですか？	大陸から黄砂が飛んできていない場合でも、高気圧に覆われて風が弱い時には、大気中に浮遊する細かなちりやほこりが風に飛ばされることなく滞留し、その結果空がかすむことがあります。気象台ではこの現象を「煙霧」として観測しています。
雨は降り始めの時が酸性が強く、だんだんと弱くなると聞きましたが本当なのでしょうか？	本当です。空気中の二酸化硫黄や窒素酸化物などの酸性物質が溶け込んだ雨が酸性雨ですが、雨の元になる雲が出来る段階で、雲粒の核として酸性物質が溶け込むという仕組みと、雨粒として雲から落ちてくる途中に、空気中に漂っている酸性物質を取り込むという仕組みの二つが合わさって酸性雨になります。二つ目の仕組みは、空気中の酸性物質を雨で洗い流すようなものですから、降り始めほどたくさんの酸性物質が含まれて酸性も強くなります。
なぜオゾンホールは南極にしか現れないのですか？	フロンガスから解離した塩素等により地球全体でオゾン層は破壊されていますが、特に南極域上空では、冬季に著しく低温になることで形成される特殊な雲の表面で塩素等によるオゾン破壊が促進され、オゾンホールが形成されます。
オゾン層が回復するのはいつごろですか？	1989年に発効したモントリオール議定書により、フロン等のオゾン層破壊物質の生産と消費が規制された結果、1990年代半ば以降大気中のフロン等の濃度の増加が止まり、ほぼ横ばいかゆっくりと減るようになっています。WMO（世界気象機関）とUNEP（国連環境計画）が発表した科学的評価（「オゾン層破壊の科学アセスメント：2014」）によると、現在の規制が守られた場合、オゾン層が1980年以前のレベルに回復するのは南極以外では今世紀半ばより少し前、南極ではそれよりやや遅れると予測されています。
日本で紫外線が一番多いのは何月ですか？	その年の天候に大きく影響されますが、一般的に夏に紫外線が多くなります。日本国内では、７～８月に年間で最も多く紫外線が観測されます。
日本では紫外線は昔と比べて増えているのですか？	紫外線は天候にも大きく影響されるため年によって多かったり少なかったりしますが、長期的に見ると、国内では観測を始めた1990年代初めから緩やかに増える傾向がみられます。
くもりや雨の時の紫外線はどれくらいの量になりますか？	快晴の時に比べると、くもりの場合は約６０％、雨の場合は約３０％の量になります。しかし、雲の間から太陽が出ている場合には、雲からの散乱光が加わるため快晴の時よりも多い紫外線が観測されることがあります。
紫外線は標高で変わりますか？	一般的には、標高が1000m高くなると紫外線は約１０％強くなるとされています。ただし、大気が非常に澄んでいる場合などには、さらに紫外線が強くなることがあります。例えば、ドイツでは1000m当たり５０％以上も増加したとの観測結果があります。
特別警報とは何ですか？	「特別警報」は、予想される現象が特に異常であるため、重大な災害の起こるおそれが著しく大きい旨を警告する新しい防災情報です。
どうして「特別警報」を創設することになったのですか？	東日本大震災では、気象庁は大津波警報などを発表しましたが、必ずしも住民の迅速な避難に繋がらなかった例がありました。また、平成２３年台風第１２号による大雨災害等においては、気象庁は警報により重大な災害への警戒を呼びかけたものの、災害発生の危険性が著しく高いことを有効に伝える手段がなく、関係市町村長による適時的確な避難勧告・指示の発令や、住民自らの迅速な避難行動に必ずしも結びつきませんでした。気象庁は、災害に対する気象庁の危機感を伝えるために、この「特別警報」を創設しました。
特別警報は、これまでの警報や注意報と、何が違うのですか？	「特別警報」は、警報の発表基準をはるかに超える現象に対して発表されます。例えば、東日本大震災における大津波や「伊勢湾台風」の高潮、「平成２３年台風第１２号」の豪雨等が発表の対象となります。
特別警報は、全て「○○特別警報」という名称で発表されるのですか？	「○○特別警報」という名称で発表するのは、大雨、暴風、高潮、波浪、大雪、暴風雪の６種類です。地震動、津波、噴火については、それぞれの既存の警報のあるレベル以上のものを特別警報に位置づけており、名称の変更はありません。
特別警報はどのように伝えられるのですか？	特別警報は、地域住民に対して、他の警報などの防災気象情報と同様に、市町村やテレビ・ラジオなどのマスメディアを通じて伝えられます。市町村に対しては、都道府県、警察、消防などの様々なルートを通じて確実に情報伝達されます。
特別警報の創設により、警報・注意報に何か変更はあるのですか？	「特別警報」の運用開始以降も、警報や注意報は、従来どおり発表されます。
警報が発表されましたが、特別警報は発表されていないのでまだ安心ですか？	大災害のおそれがあるときは従来どおり警報を発表しますので、「特別警報」が発表されていなくても、最新の気象情報に注意し、市町村等の指示に従って避難するなど、これまでどおり警戒してください。現象の進行に応じて発表される気象情報、注意報、警報を活用して、早め早めの行動をとることが大切です。
「特別警報」という表現より「非常警報」といったような表現の方が住民に非常事態であるという意味では浸透しやすいのではないですか？	特別警報は、法律の上では警報の一種として、重大な災害の起こるおそれが著しく大きい場合に行う特別な警報として定められました。実際に発表する特別警報の具体的な名称については、広く知られた状況にあることが望ましいものです。「特別警報」という表現は、法案が国会に提出された平成25年3月頃から報道機関にも広く取り上げられ、広く知られてきている状況です。このため、「特別警報」という表現をそのまま用いています。
発表した特別警報が誤報の可能性はありますか。可能性がある場合、発表した特別警報が誤報であることの周知はどのように行うのですか？	誤報の無いよう万全を期します。万が一、誤報の場合には、現行の警報と同様、内容を訂正する続報を直ちに発信するとともに、誤報の影響が拡散しないよう最大限の措置を取ります。
緊急速報メールとは、どのようなものですか？	緊急速報メールは、携帯電話事業者（NTTドコモ、KDDI・沖縄セルラー（au）、ソフトバンク）が無料で提供するサービスで、国や地方公共団体による災害・避難情報等を、回線混雑の影響なく、特定のエリア内の対応端末（携帯電話）に一斉に配信されるものです。詳しくは、携帯電話事業者のホームページをご覧ください。NTTドコモホームページ（緊急速報「エリアメール」）（部外サイトへのリンク）auホームページ（緊急速報メール）（部外サイトへのリンク）ソフトバンクホームページ（緊急速報メール）（部外サイトへのリンク）
緊急地震速報や気象等に関する特別警報を知らせる緊急速報メールが携帯電話に届いたのですが、気象庁からの情報ですか？	気象庁では、緊急地震速報、津波警報、気象等に関する特別警報、噴火に関する特別警報について、携帯電話事業者を介して、携帯電話ユーザーに緊急速報メールで配信しています。詳しくは気象庁ホームページの「特別警報等の緊急速報メールによる配信のページ」をご覧ください。
緊急速報メールが届かなかった人がいるのですが、それはなぜですか？	携帯電話で緊急速報メールを受信するには、使用している携帯電話が受信対応機種であること、受信のための設定が行われていることが必要です。（移動中や電波の悪い場所では、緊急速報メールを受信できないことがあります。）携帯電話各事業者のホームページでは、対応機種及び受信するための設定などの詳細についてご案内していますので、ご確認ください。　NTTドコモホームページ：　緊急速報「エリアメール」、設定方法ページ（部外サイトへのリンク）　auホームページ：　緊急速報メール（部外サイトへのリンク）　ソフトバンクホームページ：　緊急速報メール、設定方法ページ（部外サイトへのリンク）
気象庁ホームページの配色が悪いと思いますが、改善できませんか？	気象庁では、平成２４年５月にホームページにおける気象情報の色合いの統一を図り、全体的に配色を見直したところです、今後とも気象情報や地震情報の配色など、更に見やすくなるよう改善に向けて検討します。（参考）気象庁ホームページにおける気象情報の色合いの統一について[PDF形式]
表示内容が古いですが？	お使いのパソコンに古いデータがキャッシュされている場合があります。更新ボタンをクリックしても症状が変わらない場合は、ブラウザの設定でキュッシュをクリアしてください。
図情報が表示されないですが？	お使いのブラウザでJavascriptの設定が無効になっている可能性があります。ブラウザの設定でJavascriptの設定を「有効」にしてご覧ください。　（参考）Javascriptの設定
気象庁ではどのような仕事をしていますか？	気象庁では、自然災害から国民の生命・財産を守るための防災気象情報の他に、交通の安全を支援する交通安全情報、農業・電力・観光などの各種産業活動を支援する産業情報、国民の日常生活に役立つ生活情報、さらには人類の将来に警鐘をならす地球温暖化など地球環境に関する情報などを発信しており、各方面で多彩な役割を果たしています。また、気象、地震、津波などの現象は国境を越えて及ぶことから、これらを把握するには国際的な協力が必要であり、気象庁は、各国の気象機関や国連の世界気象機関との緊密な連帯を図っています。その他に、自然現象の監視・予報、各種情報の適時・的確な発表、更に精度向上のため、最新の科学技術を取り込みながら技術開発等を進めています。詳細については以下を参照下さい。総合パンフレット「気象庁」パンフレット「気象庁のしごと」
気象庁で仕事をするためには、どんな資格が必要ですか？	気象庁職員は国家公務員ですので、人事院主催の国家公務員採用試験（総合職試験・一般職試験（大卒程度試験））を受験し合格する必要があります。次に気象庁が実施する採用面接を受け採用となります。また、気象大学校学生採用試験に合格し、気象大学校への入学が認められた者については一般大学と同様４年間の修学後、気象庁の現場へ配属されます。気象研究所の研究官や海洋気象観測船の乗組員については公募等による選考採用も行っています。　それぞれの採用試験の受験資格や実施時期は気象庁職員募集案内をご覧ください。
気象庁では何人の人が働いていますか？	気象庁全体で約５２００人、そのうち、気象庁本庁では約１５００人が働いています（平成２８年１０月現在）。
予報官は気象予報士の資格を持っていますか？	気象予報士は民間気象会社などが気象業務許可事業者となるために必要な資格であり、気象庁で天気予報を行う予報官には必要のない資格です。気象庁の予報官になるために特に資格は必要ありませんが、必要な研修を受け長年天気予報に関する業務についた職員が予報官になっています。
気象観測施設の届出制度とはどんなものですか	政府機関または地方公共団体が気象観測を行う場合（研究や教育のための観測を除く）、またはそれ以外の方が観測の成果を発表するため、あるいは災害の防止に利用することを目的として気象観測を行う場合には、技術上の基準に従って行い、検定に合格した気象測器を使用し、気象観測施設設置の届け出を気象庁長官に行うことを義務付ける制度です。
気象観測施設の届出制度の目的はなんですか	気象庁以外の公的機関または一般事業者等のみなさまが行う気象観測について、その成果を災害の防止・軽減、社会経済活動の円滑な推進に活用するため、正確な気象観測の実施及び観測方法の統一を確保するのが目的です。
届出が必要となる気象観測種目を教えてください	観測種目は、気圧、気温、蒸気圧、露点温度、相対湿度、風向、風速、風力、降水量、積雪深、雲、視程、日照時間、日射量、天気が対象です。これ以外の観測種目、畝の間又は苗木の間、建物又は坑道の内部等特殊な環境によって変化した気象のみを対象とする観測、臨時に行う観測（おおむね一ヶ月以内）、船舶又は航空機による観測については対象になりません。
技術上の基準とはどんなものですか	技術上の基準とは、観測の種目ごとに定められた観測の手段、観測値の最小位数(最小単位)のことです。この基準に従って観測を行うことにより、観測方法の統一が図られ一定の精度を持った観測成果として利用が可能となります。気象業務法に定める技術上の基準等の一覧表[PDF形式:70KB]
技術上の基準に従って観測を行う場合、どんな気象測器を使えばよいでしょうか	技術上の基準に従って行う気象観測においては、検定に合格した気象測器を用いる必要があります。
検定が必要となる気象測器にはどんなものがありますか	ガラス製温度計、金属製温度計、電気式温度計、ラジオゾンデ用温度計、液柱型水銀気圧計、アネロイド型気圧計、電気式気圧計、ラジオゾンデ用気圧計、乾湿式湿度計、毛髪製湿度計、露点式湿度計、電気式湿度計、ラジオゾンデ用湿度計、風杯型風速計、風車型風速計、超音波式風速計、電気式日射計、貯水型雨量計、転倒ます型雨量計、積雪計　です。
気象測器の検定制度の目的はなんですか	精度が確保されていない気象測器により観測された誤った値が公表され、災害の予防などに遅れや過ちを生じたり、社会的混乱や人命や財産に係わる重大な問題が発生するのを防ぐことを目的としています。
届出を行うことで何かメリットはありますか	正確な観測を行うために必要な気象観測の方法や気象測器の設置方法、観測環境等についての技術的なアドバイスを最寄りの気象台から受けることができます。また届出された観測施設の気象測器等を壊す等の行為をした者には、罰則の規定があります。
研究・教育のために行う気象の観測とは、どのようなものを指すのですか	研究または教育そのもののために行うものであって、それ以外には利用されないものを指します。行政業務への利活用がされる場合などには、研究、教育目的を越えていると考えられるので、技術上の基準に従った観測、届出が必要になります。
観測の成果とはなんですか	観測により得られた値（データ）のほか、合計、平均などの統計的な値なども含まれます。
観測の成果の発表とは、どういうことですか	広く大勢の人に示すことです。例えば、テレビ、ラジオでの放送、新聞などへの掲載、電光掲示板での掲示、ホームページへの掲載などが含まれます。
災害の防止に利用するための観測とはどんなものですか	自然現象等による、社会生活や人命への被害の防止に利用する観測です。
罰則はありますか	検定に合格した気象測器を用いた観測を行わなかった者、届出観測施設の気象測器を壊した者に対する罰則規定が定められています。（気象業務法第44条、46条など）
届出はどこに提出すればよいでしょうか	観測所の所在する都府県にある最寄りの気象台に提出してください。なお、北海道については、観測所の所在する地域を管轄する気象台に提出してください。
届出申請の決まった書式はあるのでしょうか	書式は特に定めていません。記入事項等については下記のページをご覧下さい。詳細は、最寄りの気象台にお問い合わせください。気象観測施設設置届出の記載事項と記載例[PDF形式:226KB]
届出書は気象台に持って行かねばいけませんか	郵送、ＦＡＸ等での受付もしています。詳細は最寄りの気象台にお尋ねください。
観測施設の住所が変更になったのですが、どうすればよいですか	観測施設の住所や観測種目などが変更になった場合は変更届が必要になります。詳細は、最寄りの気象台にお問い合わせください。気象観測施設変更届の記載事項と記載例[PDF形式:228KB]
観測をやめることになったのですが、どうすればよいですか	観測施設を廃止した場合は廃止届が必要になります。詳細は、最寄りの気象台にお問い合わせください。気象観測施設廃止届の記載事項と記載例[PDF形式:218KB]
個人や一般企業で気象観測を行っている場合、届出は必要でしょうか	個人や一般企業であっても、観測の成果を発表する場合や、災害の防止に利用する場合には届出が必要です。また、その場合には国土交通省令で定める技術上の基準に従った観測を行う必要があります。成果の発表、災害の防止に利用しない場合には届出は不要です。
個人で気象観測を行った観測値を自分のホームページで公開してもよいでしょうか	ホームページでの公開は、成果の発表にあたりますので、届出が必要です。また、その場合には技術上の基準に従った観測を行い、検定に合格した気象測器を使用する必要があります。
地方公共団体で観測を行っているが、災害の防止に利用したり、発表をしたりすることはありません。届出は必要でしょうか	政府機関や地方公共団体においては、教育や研究を目的としたもの以外は届出が必要です。
独立行政法人は政府機関又は地方公共団体とみなされるのですか	独立行政法人は、原則として政府機関又は地方公共団体以外の者です。詳細は、最寄りの気象台にお問い合わせください。
届出観測施設は全国でどのくらいありますか	平成21年3月１日現在で、約20000地点あります。
測器を登録検定機関に輸送すれば、検定を受検できるのでしょうか	登録検定機関に輸送すれば受検できます。しかし、再検定の際に、雨量計など磨耗部品のあるものは、部品交換・調整などを行わないと、合格することは難しい場合もありますので、専門業者に相談することをお薦めします。
型式証明された測器でないと検定は受けられないのでしょうか	型式証明されていない測器でも検定は受けられます。この場合、登録検定機関へ実器を提出する受検となります。
地方公共団体（または個人）が、検定を受けるにはどうしたらよいですか	登録検定機関へ申請書（検定料金が必要）を提出することで受検できます。型式証明の有無によって受検方法が異なる場合がありますので、詳しくは登録検定機関又は専門業者に相談されることをお薦めします。
検定料金には、消費税がかかりますか	消費税はかかりません。測器毎の詳しい検定料金は登録検定機関にお問い合わせください。
検定有効期間を定めていない（無期限）測器は、永久に使用できるのでしょうか	検定に合格した測器であれば、そのまま永久に使用できるという意味ではありません。通常の使用状態で、精度の悪化が想定し難いもののほか、容易に精度の確認ができるものも、有効期間を定めていない（無期限）測器としています。無期限の測器を使用する場合は、保守点検を行いながら使用することが大切です。なお、電気式湿度計は、乾湿式湿度計と随時比較点検を行ってください。
北陸地方に新潟県を含めるのはなぜですか？	気象庁では梅雨や降雪量など、すべての気象情報において新潟県は北陸地方に含めています。また、関東甲信越という区分は用いていません。このことについて補足しますと、気象庁予報警報規定（昭和２８年２月２０日運輸省告示第６３号）で、天気予報等を行う際の区分として、全国を１１に分けた地方予報区を定め、その中の北陸地方予報区は、新潟県、富山県、石川県、福井県で構成される旨規定しており、長年この定義に従って各種情報等を発表しています。
日の出・日の入り、月齢を知りたいのですが？晴れている夜空に光、隕石、火球を見たのですが？	日の出・日の入りや月齢、隕石、火球、太陽活動など、天体に関することは扱っておりませんので、国立天文台や天文学を扱う科学館等にお問合せください。　　（参考）国立天文台　天文情報センター暦計算室
避難勧告について質問したいのですが？	避難勧告・避難指示は原則として市町村長が行います。市区役所・町村役場にお問合せください。
花粉情報は気象庁で発表していますか？	気象庁では、花粉情報を発表していません。花粉の飛散に関する情報は、環境省が発表しております。（参考）環境省花粉情報サイト
ベランダや自動車の上に黄色、黄緑色の粉が付着していますが、何ですか？	花粉の季節であれば花粉の可能性がありますが、気象庁では花粉の観測や予想をしておりません。環境省等にお問合せください。（参考）環境省花粉情報サイト
「花粉症記念日」(３月７日)とはなんですか？	インターネットで「花粉症記念日」や「３月７日 何の日」などの言葉を検索しますと、「1993年３月７日に気象庁が花粉症対策として花粉飛散情報の発表を開始した日」といった解説が多く見られます。しかし、このような事実はありません。気象庁では花粉飛散情報を発表していませんし、これまでも発表したことはありません。また、「花粉症記念日」といった記念日の制定もしていません。
気象庁で微小粒子状物質(PM2.5)に関する情報を発表していますか？	気象庁では、微小粒子状物質(PM2.5)に関する情報は発表していません。微小粒子状物質(PM2.5)を含む全国の大気汚染状況に関する情報は、環境省 微小粒子状物質(PM2.5)に関する情報をご覧ください。
気象庁で放射能に関する情報を発表していますか？	気象庁では、放射線のモニタリング（観測）や放射性物質の拡散予測に関する情報は発表していません。放射線のモニタリングや放射物質の拡散予測に関する情報は、原子力規制委員会の下記をご覧ください。　放射線モニタリング情報　緊急時迅速放射能影響予測ネットワークシステム(SPEEDI）